###############################################################################
# large_abstract.des: Large regular vaults go here (these are defined by having an
#                     ORIENT line with argument, north, northwest etc. This file
#                     is for abstract vaults - defined here as being vaults which
#                     do not use a custom set of monsters, and/or have a more
#                     abstract layout (often based on geometric shapes and
#                     patterns).
#
# Note that all maps for the Vaults branch system (including Vaults:$) reside in
# vaults.des.
###############################################################################

: crawl_require('dlua/vault.lua')

default-depth: Depths, !Depths:$

###############################################################################

############################################################################
# four-leaf vault
#
NAME:   four-leaf_vault
DEPTH:  Depths, !Depths:$
WEIGHT: 1
ORIENT: northwest
MAP
xxxxxxxxxxxxxxxxxxxxxxxxxxxxxxxxx
xxxxxxxxxxxxxxxxxxxxxxxxxxxxxxxxx
xxxxxx......................xxxxx
xxxxx...cccccccc..cccccccc...xxxx
xxxx...ccxxxxxxc..cxxxxxxcc...xxx
xxx...cc......xc..cx......cc...xx
xx...cc.......xc..cx.......cc...x
xx..cc........xc..cx........cc..x
xx..cx........xc..cx........xc..x
xx..cx........xc..cx........xc..x
xx..cx......+xx....xx+......xc..x
xx..cx......x........x......xc..x
xx..cxxxxxxxx........xxxxxxxxc..x
xx..cccccccc..........cccccccc..x
xx..............TT..............x
xx..............TT..............x
xx..cccccccc..........cccccccc..x
xx..cxxxxxxxx........xxxxxxxxc..x
xx..cx......x........x......xc..x
xx..cx......+xx....xx+......xc..x
xx..cx........xc..cx........xc..x
xx..cx........xc..cx........xc..x
xx..cc........xc..cx........cc..x
xx...cc.......xc..cx.......cc...x
xxx...cc......xc..cx......cc...xx
xxxx...ccxxxxxxc..cxxxxxxcc...xxx
xxxxx...cccccccc..cccccccc...xxxx
xxxxxx......................xxxxx
xxxxxxxxxxxxxxxx..xxxxxxxxxxxxxxx
xxxxxxxxxxxxxxxx++xxxxxxxxxxxxxxx
xxxxxxxxxxxxxxxx@xxxxxxxxxxxxxxxx
ENDMAP

############################################################################
# Cross-vault
#
NAME:   cross_vault
DEPTH:  Depths, !Depths:$
WEIGHT: 1
ORIENT: northwest
MAP
xxxxxxxxxxxxxxxxxxxxxxxxxxxxxxxxx
xxxxxxxxxxx............xxxxxxxxxx
xxxxxxxx..................xxxxxxx
xxxxxx......................xxxxx
xxxxx..........w..w..........xxxx
xxxx........wwww++wwww........xxx
xxxx......wwwvvv..vvvwww......xxx
xxx......wwwwv......vwwww......xx
xxx.....wwwwwv......vwwwww.....xx
xxx....wwwwwvv......vvwwwww....xx
xx....wwwwwvv........vvwwwww....x
xx....wwvvvv....vv....vvvvww....x
xx...wwwv......vvvv......vwww...x
xx...wwwv....vv.vv.vv....vwww...x
xx..wwwwv...vvvv..vvvv...vwwww..x
xx..wwwwv...vvvv..vvvv...vwwww..x
xx..wwwwv....vv.vv.vv....vwwww..x
xx...wwwv......vvvv......vwww...x
xx...wwwvvvv....vv....vvvvwww...x
xx....wwwwwvv........vvwwwww....x
xxx...wwwwwwvv......vvwwwwww...xx
xxx....wwwwwwv......vwwwwww....xx
xxx.....wwwwwv......vwwwww.....xx
xxxx.....wwwwvvvvvvvvwwww.....xxx
xxxx.......wwwwwwwwwwww.......xxx
xxxxx.........wwwwww.........xxxx
xxxxxx......................xxxxx
xxxxxxxx.......x++x.......xxxxxxx
xxxxxxxxxxx...xx..xx...xxxxxxxxxx
xxxxxxxxxxxxxxx..@.xxxxxxxxxxxxxx
ENDMAP

NAME:    minmay_triangles_in_corner
ORIENT:  southeast
TAGS:    transparent
WEIGHT:  1
DEPTH:   Depths
SUBST:   c : xcv
MAP
                        ...x
                       ...cx
                      ...ccx
                     ...cccx
                    ...ccc.x
                   ...ccc..x
                  ...ccc...x
                 ...ccc....x
                ...ccc.xxxxx
               ...ccc.x....x
              ...ccc.x.x...x
             ...ccc..x..x..x
            ...ccc...x...x.x
           ....cc....x....xx
          .......xxxx.xxxx.x
         ...cc.cc....x....xx
        ...ccc.ccc...x...x.x
       ...ccc.x.ccc..x..x..x
      ...ccc..x..ccc.x.x...x
     ...ccc...x...ccc.x....x
    ...ccc....x....ccc.xxxxx
   ...ccc.xxxx.xxxx.ccc....x
  ...ccc.x....x....x.ccc...x
 ...ccc.x.x...x...x.x.ccc..x
...ccc..x..x..x..x..x..ccc.x
..ccc...x...x.x.x...x...cccx
.ccc....x....x.x....x....ccx
xxxxxxxxxxxxxxxxxxxxxxxxxxxx
ENDMAP

NAME:   minmay_fractal_lines_corner
ORIENT: northwest
TAGS:   transparent
WEIGHT: 1
DEPTH:  Depths
SUBST:  z : xcvb
MAP
xxxxxxxxxxxxxxxxxxxxxxxxxxxx
x...........................
x...........................
x..zz........zz.........zz..
x..zzz......zzz........zzz..
x...zzz....zzz........zzz...
x....zzz..zzz........zzz...
x.....zzzzzz........zzz...
x......zzzz........zzz...
x......zzzz.......zzz...
x.....zzzzzz.....zzz...
x....zzz..zzz...zzz...
x...zzz....zzz.zzz...
x..zzz......zzzzz...
x..zz........zzz...
x...........zzz...
x..........zzz...
x.........zzz...
x........zzz...
x.......zzz...
x......zzz...
x.....zzz...
x....zzz...
x...zzz...
x..zzz...
x..zz...
x......
x.....
ENDMAP

NAME:   minmay_stepped
ORIENT: northwest
TAGS:   transparent
WEIGHT: 1
DEPTH:  Depths
SUBST:  z : xcvb
MAP
xxxxxxxxxxxxxxxxxxxxxxxxxxx
x..........................
x..........................
x..zz..zzz..zzz..zzz..zzz..
x..z...z....z....z....z....
x......z....z....z....z....
x.....zz..zzz..zzz..zzz..
x..zzzz...z....z....z....
x..z......z....z....z....
x..z.....zz..zzz..zzz..
x.....zzzz...z....z....
x.....z......z....z....
x..zzzz.....zz..zzz..
x..z.....zzzz...z....
x..z.....z......z....
x.....zzzz.....zz..
x.....z.....zzzz...
x..zzzz.....z......
x..z.....zzzz.....
x..z.....z.....
x.....zzzz.....
x.....z.....
x..zzzz.....
x..z.....
x..z.....
x.....
x.....
ENDMAP

NAME:   minmay_outward_triangles
ORIENT: northwest
TAGS:   transparent
WEIGHT: 1
DEPTH:  Depths
SUBST:  z : xcvb
MAP
xxxxxxxxxxxxxxxxxxxxxxxxxxx
x..........................
x..........................
x..zzz.....zzzzzz.....zzz..
x..zz......zzzzz......zz...
x..z.......zzzz.......z....
x..........zzz............
x......zzz.zz.....zzz....
x......zz..z......zz....
x......z..........z....
x.....................
x..zzzzzz..zzzzzz....
x..zzzzz...zzzzz....
x..zzzz....zzzz....
x..zzz.....zzz....
x..zz......zz....
x..z.......z....
x..............
x......zzz....
x......zz....
x......z....
x..........
x..zzz....
x..zz....
x..z....
x......
x.....
ENDMAP

NAME:  grunt_bent_corner
DEPTH: Depths, !Depths:$
WEIGHT: 1
ORIENT: northwest
MAP
xxxxxxxxxxxxxxxxxxcccccc
xxcccccxxxxxxcccccc....ccccc
xcc...ccxxxcccc...+c......ccc
xc.....cxccc.......c........cc
xc.....ccc.........c+........c
xc.....ccc+.........cccc+cc+cc
xcc...+c..cc.....cccccc......c
xxccccc....+c.ccccc..+......cc
xxxxxc......ccc......cc....cc
xxxccc.....cc.+.......c+..cc
xxxc.+c...cc..cc.......cccc
xxcc..c+.cc....cc....cccc
xxc....ccc......c+.ccc
xcc.....c........ccc
xcc....cc+c....c+ccc
xc.....c..cc..cc...cc
xc.....c...cc.+.....cc
xc....cc....+cc..G...c
cc+...cc.....cc......
c.ccc.c.....cccc...@
c...+cc.....c  cc..
c....cc+c..cc   cc
c....cc.cc.c
cc...c...+cc
 c...+....cc
 c...c....c
 cc..c...cc
 cc..+..cc
  cc.c.cc
   ccccc
ENDMAP

NAME:   grunt_twisty_corner
ORIENT: southwest
WEIGHT: 1
DEPTH:  Depths, !Depths:$
MAP
xxxxxxxxxxxxxxxxxxxxxxxxxxc@
xxxxxxx........ccxxxxxxxxxx.@
xxxxxx..........ccxxxxxxxx...@
xxxxx...xxxxxxx..cxxxxxxx..G..@
xxxxx..xxxxxxxxx.cxxxxxx.....xx
xxxxx..xx.+...xx.cxxxxx.....xxx
xxxxx..xx.x...xx.cxxxx.....xxxx
xxxxx..xx.x...xx.cxxx.....xxxxx
xxxxx..xx.xxxxx..cxx.....xxxxxx
xxxxx..xx..xxx..ccx.....xxxxxxx
xxxxx..xxx.....ccx.....xxxxxxxx
xxxxx...xcccccccx.....xxxxxxxxx
xxxxxx...xxxxxxx.....xxxxxxxxxx
xxxxxxx.......x.....cccccccccxx
xxxxxxxxx..........ccx......ccx
xxxxccccccccc.....xcx..xxxx..cx
xxxcc.......c+...xxc..xxxxxx..x
xxcc.........++...xc.xx...xx..x
xcc...........cc..xc.xx...xx..x
xc....ccccc....c..xc.xx...xx..x
xc...cc...cc...c..xc..xxx+xx..x
xc...c.....c...c..xcx.....xx..x
xc...c.....c...cx..xxxxxxxxx..x
xc...c.....c...cx...xxxxxxx...x
xc...++...cc...cxx...........xx
xc....+cccc....cxxx.........xxx
xcc...........ccxxxxxxxxxxxxxxx
xxcc.........ccxxxxxxxxxxxxxxxx
xxxcc.......ccxxxxxxxxxxxxxxxxx
xxxxcccccccccxxxxxxxxxxxxxxxxxx
xxxxxxxxxxxxxxxxxxxxxxxxxxxxxxx
ENDMAP

NAME:   kennysheep_snake
ORIENT: west
WEIGHT: 1
TAGS:   no_trap_gen
DEPTH:  Depths, !Depths:$, Workshop
MAP
     cccccccccc
    cc........cc
   cc.cccccccc.cc    cccc
  cc.cc......cc.cc  cc..cc
 cc.cc.cccccc.cc.cccc....cc
cc.cc.cc....cc.cc.cc......+
c.cc.cc.cccc.cc.cc.c......+
c.c.cc.cc..cc.cc.c.c.....cc
c.c.c.cc....cc.c.c.c.c..cc
c.c.c.c......c.c.c.c.cccc
c.c.c.c......c.c.c.c.c
c.c.c.cc....cc.c.c.c.c
c.c.cc.cc..cc.cc.c.c.c
c.cc.cc.c.cc.cc.cc.c.c
cc.cc.c.cc..cc.cc.cc.c
 cc.c.cc.cccc.cc.cc.cc
  c.cc.cc....ccc.cc.cc
  cc.cc.ccccccccc.cc.cc
   cc.cc........cc.cc.c
    cc.ccc.cc....cc.c.c
     cc..c.c......c.c.c
      cc.c.c......c.c.c
       c.c.cc....cc.c.c
       c.cc.cc..cc.cc.c
       cc.cc.cccc.cc.cc
        cc.cc....cc.cc
         cc.cccccc.cc
          cc......cc
           cccccccc
ENDMAP

NAME:   nicolae_aperiodic_l_corner
TAGS:   transparent
WEIGHT: 1
DEPTH:  Depths
ORIENT: southwest
MAP
ccccccccccccccccc
c.......c.......c
c.......+.......c
c.......c.......c
c...ccccccccc...c
c...c.......c...c
c...c.......+...c
c...c.......c...c
cc+cc...cccccc+cc
c...c...c.......c
c...c...c.......c
c...c...c.......c
c...cc+cc...cc+cc
c.......c...c...c@@@
c.......c...c.T.+..@
c.......c...c...c..@
cc+ccccccc+cc...cc+cccccccccccccc
c.......c...c.......c...c.......c
c.......c...c.T...T.+...+.......c
c.......c...c.......c...c.......c
c...cc+cc...ccccccccc...cc+cc...c
c...c...c.......c.......c...c...c
c...c...c.......+.......c...c...c
c...c...c.......c.......c...c...c
cc+cc...ccccccccccccccccc...cc+cc
c...c.......c...c...c.......c...c
c...c.......+...c...+.......c...c
c...c.......c...c...c.......c...c
c...ccccccccc...c...ccccccccc...c
c.......c.......c.......c.......c
c.......+.......+.......+.......c
c.......c.......c.......c.......c
ccccccccccccccccccccccccccccccccc
ENDMAP

NAME:   minmay_smoke_and_mirrors
ORIENT: northwest
DEPTH:  D:3-
WEIGHT: 1
MARKER: F = lua:fog_machine { cloud_type="purple smoke", \
            pow_min = 5, pow_max = 15, delay_min = 10,   \
            delay_max = 50, size_min = 1, size_max = 5,  \
            walk_dist = 0, spread_rate= 100 }
SUBST:  F = .
MAP
xxxxxxxxxxxxxxxxxxxxxxxxxx
xbbbbbbbbbbbbbbbbbbbbbbbbb
xb....................Fbb.
xb...bbbbb............bb..
xb..bb...bb..........bb...
xb.bb.....bb........bb....
xb.........bb......bb.....
xb..........bb....bb......
xb.....bb...FbbbbbbF.....
xb....bb....bb....bb.....
xb...bb....bb......bb....
xb..bb....bb........bb...
xbbbb....bb....bb...Fbb..
xb..bb........bb....bb..
xb...bb......bb....bb...
xb....bb....bb....bb....
xb.....bbbbbb....bb.....
xbbb........bb.........
xb.bb........bb........
xb..bb........bb.......
xb...bb........bb.....
xb...Fbb.............
xb...bb.............
xb..bb...........
xb.bb........
xb......
ENDMAP
