##############################################################################
# mini_monsters.des: This is the place for minivaults with monsters.
#
# So all vaults in this file should have no ORIENT lines but they should
# contain MONS or KMONS lines.

# Additionally, maps that only place in one branch where that branch is not
# Dungeon or Depths should go in the corresponding branch DES file. Vaults with
# ORIENT lines are stored in float.des or large.des. Minivaults without
# monsters go to mini_features.des.
#
# Sections:
# <<1>> Invertebrae        (insects, spiders, worms)
# <<2>> Vertebrae          (mammals, reptiles, also serpents, dragons)
# <<3>> Humanoids          (including centaurs, spriggans)
# <<4>> Demons and undead
# <<5>> Fixed shooters     (statues, oklobs, fog generators)
# <<6>> Others             (slime denizens, insubstantial monsters)
# <<7>> Random             (using 8,9,0 or too many monsters to categorise)
# <<8>> Guardians          (thematic vaults centered around special items)
# <<9>> Manuals            (pre-lair vaults placing manuals with guardians)
# <<10>> Classics           (ancient minivaults and extensions)
#
# Often, a vault will fit in two categories. Choose the one you think fits
# best or else delegate to Random or Others. Be picky with Guardians, please.
###############################################################################

: crawl_require('dlua/vault.lua')

{{
-- Functionality for some Grunt vaults.
function grunt_ministairs_setup(e, hatches)
  if you.in_branch("Crypt") or you.in_branch("Sanctum") then
    e.shuffle("GT")
    if you.in_branch("Crypt") then
      e.subst("T = T V:20 Y:1")
      e.subst("x = c")
    end
  else
    e.shuffle("GTt")
    e.subst("T = T:20 V U:1")
    if you.in_branch("D") or you.in_branch("Depths") then
      init_hm_decor_walldepth(e, 'x')
    end
  end
  if hatches then
    e.shuffle("{[(<}])>")
  else
    e.shuffle("{[(}])")
  end
  e.subst("+ = +.")
end

function random_stair(e, symbol)
  local valid;
  if you.depth() > 1 then
    valid = "([{"
  else
    valid = "" -- should always coincide with depth_fraction() < 1
  end
  if you.depth_fraction() < 1 then
    valid = valid .. ")]}"
  end
  if valid == "" then
    valid = "." -- shouldn't happen outside validation/caching
  end
  e.subst(symbol .. " = " .. valid)
end
}}

default-depth: D:9-, Depths, Tower

################################################################################
#
# <<4>> Demons and undead
#
################################################################################

NAME:    nicolae_neqoxec_dot_bat
TAGS:    transparent
DEPTH:   D
WEIGHT:  1
MAP
           cccccc
         cccccccccc
       cccc......cccc
  cc@@ccc..........ccc@@cc
 cc...cc....cccc....cc...cc
 cc..cc...cccccccc...cc..cc
cc...cc..ccc....ccc..cc...cc
cc..cc...........cc.......cc
cc..cc............cc......cc
cc..cccccc...GG...cccccc..cc
cc..cccccc...GG...cccccc..cc
cc......cc............cc..cc
cc.......cc...........cc..cc
cc...cc..ccc....ccc..cc...cc
 cc..cc...cccccccc...cc..cc
 cc...cc....cccc....cc...cc
  cc@@ccc..........ccc@@cc
       cccc......cccc
         cccccccccc
           cccccc
ENDMAP

###################################################################
#
# <<7>> Random monsters
#       Either using 8, 9, 0 glyphs or just many choices.
#
###################################################################

NAME:   minmay_circled_x
TAGS:   transparent
DEPTH:  D
WEIGHT: 3
MAP
     ......
   ...xxxx...
  ..xx....xx..
 ..x........x..
 .x.x......x.x.
..x..x....x..x..
.x....x..x....x.
.x.....xx.....x.
.x.....xx.....x.
.x....x..x....x.
..x..x....x..x..
 .x.x......x.x.
 ..x........x..
  ..xx....xx..
   ...xxxx...
     ......
ENDMAP

NAME:   minmay_three_crescents
TAGS:   transparent
DEPTH:  D
WEIGHT: 3
MAP
 .....
..xxx..
.xx.xx..
.x.........
.xx....xxx..
..x......xx.
 .........x.
..x......xx.
.xx....xxx..
.x.........
.xx.xx.
..xxx..
 .....
ENDMAP

NAME:   minmay_divided_ellipse
TAGS:   transparent
DEPTH:  D
WEIGHT: 5
MAP
      .......
   ....xx+xx....
 ...xxxx...xxxx...
..xxx..x...x..xxx..
.xx.x..x...x..x.xx.
.+..x..x...x..x..+.
.xx.x..x...x..x.xx.
..xxx..x...x..xxx..
 ...xx+x...x+xx...
   ....xxxxx....
      .......
ENDMAP

NAME:  kb_rosetta
TAGS:  vaults_hard transparent
DEPTH: D, Depths, Tower
SUBST: x : xcvmnt
SUBST: X : GtTU
MAP
   ...   ...
  ..x.. ..x..
 ...xx...xx...
....xxx.xxx....
.xxx.xx.xx.xxx.
..xxx.x.x.xxx..
 ..xxxx.xxxx..
  .....X.....
 ..xxxx.xxxx..
..xxx.x.x.xxx..
.xxx.xx.xx.xxx.
....xxx.xxx....
 ...xx...xx...
  ..x.. ..x..
   ...   ...
ENDMAP

NAME:   minmay_close_crescents
TAGS:   transparent
DEPTH:  D
MAP
 .........
..xxxx..x..
.xx..xx.xx.
.x....x..x.
.x..x....x.
.xx.xx..xx.
..x..xxxx..
 .........
ENDMAP

NAME:   minmay_cut_off
TAGS:   transparent
DEPTH:  D
MAP
.
..
.x.
.x..
.x.x.
.x.xx.
.x..xx.
.xxxxxx.
 .xx..x.
  .xx.x.
   .x.x.
    ..x.
     .x.
      ..
       .
ENDMAP

NAME:   minmay_cupped
TAGS:   transparent
DEPTH:  D
MAP
..........
.xxx...xx.
.x.xx..xx.
.xx.xx..x.
..xx....x.
...x...xx.
......xxx.
.xx..xxx..
.xxxxxx...
.........
ENDMAP

NAME:   minmay_unequal
TAGS:   transparent
DEPTH:  D
MAP
........
.xxx......
...xxx....
.....xxx...
.......xxx.
.....xxx...
...xxx.....
.xxx...xxx.
.....xxx...
...xxx.....
.xxx.......
...xxx.....
 ....xxx...
 ......xxx.
   ........
ENDMAP

NAME:   minmay_quantized
TAGS:   transparent
DEPTH:  D
MAP
    .....
    .xxx.
  ...x.x...
  .xxx.xxx.
...x.....x...
.xxx.xxx.xxx.
.....xxx...x.
.xxx.xxx.xxx.
...x.....x...
  .xxx.xxx.
  ...x.x...
    .xxx.
    .....
ENDMAP

NAME:   minmay_ruptured
TAGS:   transparent
DEPTH:  D
MAP
 ..................
...xx.xx.....xx.xx..
.xxx.x.xx.x.xx.x.xx.
.x...x...xxx...x..x.
.xxx.x.xx.x.xx.x.xx.
...xx.xx.....xx.xx..
 ..................
ENDMAP

NAME:    minmay_diamond_spiral
TAGS:    transparent
DEPTH:   D
WEIGHT:  4
SUBST:   ? = .G+m
SHUFFLE: xcvb / mnnn
MAP
          .
         .x.
        ..xx.
       .x..xx.
      .xxx..xx.
     .xx.xx..xx.
    .xx...xx..xx.
   .xx..x..xx..xx.
  .xx..xxx..xx..xx.
 .xx..xx.xx..xx..xx.
.xx..xx...?...xx..xx.
 .xx..xx..xx.xx..xx.
  .xx..xx..xxx..xx.
   .xx..xx..x..xx.
    .xx..xx...xx.
     .xx..xx.xx.
      .xx..xxx.
       .xx..x.
        .xx..
         .x.
          .
ENDMAP

NAME:    minmay_radiant
TAGS:    transparent
WEIGHT:  4
DEPTH:   D
SUBST:   x : xcvbnm G:1
MAP
 ..........
....xxxxx.....
..xxx..........
..x......xxxx...
.xx.........xx..
.x...xxx.....x..
.x...x...xx..x...
.x...x....x..x...
.x.............x.
...x..x....x...x.
...x..xx...x...x.
 ..x.....xxx...x.
 ..xx.........xx.
 ...xxxx......x..
 ...........xxx..
 .......xxxxx....
      ..........
ENDMAP

# Some miniature stair vaults; these all place a couple of monsters,
# but they're mainly around for the decor (same principle as st's).
NAME:    grunt_ministairs_1
TAGS:    extra transparent allow_dup luniq_grunt_ministairs
DEPTH:   D, Depths, Sanctum, Workshop, Tower, Crypt
: grunt_ministairs_setup(_G, false)
MAP
  ...
 ..G..
.......
...{...
.......
 G...G
  ...
ENDMAP

NAME:    grunt_ministairs_2
TAGS:    extra transparent allow_dup luniq_grunt_ministairs
DEPTH:   D, Depths, Sanctum, Workshop, Tower, Crypt
: grunt_ministairs_setup(_G, false)
MAP
   .....
  .G...G.
 .........
.G...{...G.
 .........
  .G...G.
   .....
ENDMAP

NAME:    grunt_ministairs_3
TAGS:    extra transparent allow_dup luniq_grunt_ministairs
DEPTH:   D, Depths, Sanctum, Workshop, Tower, Crypt
: grunt_ministairs_setup(_G, false)
MAP
    @
xxxx+xxxx
x.......x
x.G...G.x
x.......x
x.G...G.x
x.......x
x.G...G.x
x...{...x
xxxxxxxxx
ENDMAP

NAME:    grunt_ministairs_4
TAGS:    extra transparent allow_dup luniq_grunt_ministairs
DEPTH:   D, Depths, Sanctum, Workshop, Tower, Crypt
: grunt_ministairs_setup(_G, true)
NSUBST:  @ = 1:@ / *:.
MAP
       .@.
       @G@
 xxxxx.....xxxxx
xx...+xx+xx+...xx
x{.G..xx.xx..G.(x
xx...xx...xx...xx
 xxxxxx.G.xxxxxx
      x...x
      xx[xx
       xxx
ENDMAP

NAME:    grunt_ministairs_5
TAGS:    extra transparent allow_dup luniq_grunt_ministairs
DEPTH:   D, Depths, Sanctum, Workshop, Tower, Crypt
: grunt_ministairs_setup(_G, true)
MAP
        @
 xxxxxxx+xxxxxxx
xx...xx...xx...xx
x{.G..+.G.+..G.(x
xx...xx...xx...xx
 xxxxxxx+xxxxxxx
      xx.xx
      x...x
      x.G.x
      x...x
      xx[xx
       xxx
ENDMAP

NAME:    grunt_ministairs_6
TAGS:    extra transparent allow_dup luniq_grunt_ministairs
DEPTH:   D, Depths, Sanctum, Workshop, Tower, Crypt
: grunt_ministairs_setup(_G, true)
NSUBST:  @ = 1:@ / *:.
MAP
xxxx .@..xxxx
x{.xx...xx.[x
x...x...x...x
xx.+x...x+.xx
 xxx.....xxx
.............
@.....G.....@
.............
 xxx.....xxx
xx.+x...x+.xx
x...x...x...x
x(.xx...xx.<x
xxxx .@..xxxx
ENDMAP

NAME:    grunt_ministairs_7
TAGS:    extra transparent allow_dup luniq_grunt_ministairs
DEPTH:   D, Depths, Sanctum, Workshop, Tower, Crypt
: grunt_ministairs_setup(_G, true)
MAP
    @
  xx+xx
 xx...xx
xxG...Gxx
x.......x
x.{.G.(.x
x.......x
xxG.[.Gxx
 xx...xx
  xxxxx
ENDMAP

NAME:    grunt_ministairs_8
TAGS:    extra transparent allow_dup luniq_grunt_ministairs
DEPTH:   D, Depths, Sanctum, Workshop, Tower, Crypt
: grunt_ministairs_setup(_G, false)
MAP
    xxx
   xxGx
  xx..+@
 xx..Gx
xx...xx
xG..xx
x.{.x
xG..xx
xx...xx
 xx..Gx
  xx..+@
   xxGx
    xxx
ENDMAP

NAME:    grunt_ministairs_9
TAGS:    extra transparent allow_dup luniq_grunt_ministairs
DEPTH:   D, Depths, Sanctum, Workshop, Tower, Crypt
: grunt_ministairs_setup(_G, false)
MAP
 xx...
xx..G..
x.......
x.....G..
x..{....@
x.....G..
x.......
xx..G..
 xx...
ENDMAP

NAME:    grunt_ministairs_10
TAGS:    extra transparent allow_dup luniq_grunt_ministairs
DEPTH:   D, Depths, Sanctum, Workshop, Tower, Crypt
: grunt_ministairs_setup(_G, true)
NSUBST:  @ = 1:@ / *:.
MAP
 xx...@...xx
xx..G...G..xx
x...........x
x.....G.....x
x..{.....(..x
x.....G.....x
x...........x
xx..G...G..xx
 xx...@...xx
ENDMAP

NAME:    grunt_ministairs_11
TAGS:    extra transparent allow_dup luniq_grunt_ministairs
DEPTH:   D, Depths, Sanctum, Workshop, Tower, Crypt
: grunt_ministairs_setup(_G, false)
NSUBST:  @ = 1:@ / *:.
MAP
     @
 xxxx+xxxx
xx.......xx
x.GxxxxxG.x
x.xx...xx.x
x.x.G.G.x.x
x.x..{..x.x
x.x.G.G.x.x
x.xx...xx.x
x.Gxx+xxG.x
xx.......xx
 xxxxxxxxx
ENDMAP

NAME:    grunt_ministairs_12
TAGS:    extra transparent allow_dup luniq_grunt_ministairs
DEPTH:   D, Depths, Sanctum, Workshop, Tower, Crypt
: grunt_ministairs_setup(_G, true)
MAP
xxxxx     xxxxx
x...xxx xxx...x
x.{...xxx...[.x
x.............x
xxx....G....xxx
  xxx.....xxx
    xx.@.xx
ENDMAP

NAME:    grunt_ministairs_13
TAGS:    extra transparent allow_dup luniq_grunt_ministairs
DEPTH:   D, Depths, Sanctum, Workshop, Tower, Crypt
: grunt_ministairs_setup(_G, true)
MAP
   @         @
 xx+xx     xx+xx
 x...xxx xxx...x
@+.G...xxx...G.+@
 x.............x
 xxx....{....xxx
   xxx.....xxx
     xx.G.xx
   xxx.....xxx
 xxx....(....xxx
 x.............x
@+.G...xxx...G.+@
 x...xxx xxx...x
 xx+xx     xx+xx
   @         @
ENDMAP

NAME:    grunt_ministairs_14
TAGS:    extra transparent allow_dup luniq_grunt_ministairs
DEPTH:   D, Depths, Sanctum, Workshop, Tower, Crypt
: grunt_ministairs_setup(_G, false)
MAP
      @
     x+x
     x.xx
xxxxxx..xx
x........xx
x.{...G...+@
x........xx
xxxxxx..xx
     x.xx
     x+x
      @
ENDMAP

NAME:    grunt_ministairs_15
TAGS:    extra transparent allow_dup luniq_grunt_ministairs
DEPTH:   D, Depths, Sanctum, Workshop, Tower, Crypt
: grunt_ministairs_setup(_G, true)
MAP
     @     @
    x+x   x+x
   xx.x   x.xx
  xx..xxxxx..xx
 xx...........xx
@+...G..{..G...+@
 xx...........xx
  xx..xxxxx..xx
   xx.x   x.xx
    x+x   x+x
     @     @
ENDMAP

NAME:    minmay_randomly_rotated_circles
TAGS:    transparent
DEPTH:   D
SHUFFLE: ABCDEFGH
SHUFFLE: IJKLMNOP
SUBST:   AI : ., BCDEFGHJKLMNOP : x
SUBST:   b : bxcvm
MAP
    ........
  ...BBBCCC...
 ..BBB....CCC..
 .AA........CD.
..A..JJJKKK..D..
.AA.II....KL.DD.
.A..I......L..D.
.A..I..bb..L..D.
.H..P..bb..M..E.
.H..P......M..E.
.HH.PO....MM.EE.
..H..OOONNN..E..
 .HG........EE.
 ..GGG....FFF..
  ...GGGFFF...
    ........
ENDMAP

NAME:    minmay_swirly_circle
TAGS:    transparent
WEIGHT:  1
DEPTH:   Depths
SUBST:   x : ccvvb
MAP
       ........
    ....xxxxxx....
   ..xxxx.....xxx..
  ..xxxx.xxxxxxxxx..
 ..xx.xx.xx.xxx..xx..
 .xx.xxx.xxx.x.xx.xx.
 .xx.xxx.xxx.x.xxxxx.
..xxx...x...xx.xxxxx..
.x.xxxxxxxxx.xx....xx.
.x.xx..x..xx.x.xxxx.x.
.x.x.xx.xx..xx.xxxx.x.
.x.xxxx.xx..xx.xx.x.x.
.x.xxxx.x.xx..x..xx.x.
.xx....xx.xxxxxxxxx.x.
..xxxxx.xx...x...xxx..
 .xxxxx.x.xxx.xxx.xx.
 .xx.xx.x.xxx.xxx.xx.
 ..xx..xxx.xx.xx.xx..
  ..xxxxxxxxx.xxxx..
   ..xxx.....xxxx..
    ....xxxxxx....
       ........
ENDMAP

NAME:   minmay_indecisive_spiral
TAGS:   transparent
DEPTH:  D
MAP
...........
.xxx.xxx.x.
...xxx...x.
.x.x.x.xxx.
.x......x..
.xxx.x.xxx.
..x......x.
.xxx.x.x.x.
.x...xxx...
.x.xxx.xxx.
...........
ENDMAP

NAME:  minmay_starry_boxes
TAGS:  transparent
WEIGHT: 1
DEPTH: D,Depths
SUBST: x : xxxxxxcvb
MAP
 ...............
..xx...xxx...xx..
.xxx.x.x.x.x.xxx.
.xxx...x.x...xxx.
....xxx...xxx....
..x.x.x.x.x.x.x..
....xx.x.x.xx....
.xxx..x.x.x..xxx.
.x...x.x.x.x...x.
.xxx..x.x.x..xxx.
....xx.x.x.xx....
..x.x.x.x.x.x.x..
....xxx...xxx....
.xxx...x.x...xxx.
.xxx.x.x.x.x.xxx.
..xx...xxx...xx..
 ...............
ENDMAP

NAME:   minmay_diced_spiral
TAGS:   transparent
WEIGHT: 1
DEPTH:  D:2-
MAP
..................
.xxxx.xxx.xx.x.xx.
.xxxx.xxx.xx.x.xx.
...............xx.
.xx.xxx.xx.x.x.xx.
.............x....
.xx.x.xx.x.x.x.xx.
.xx........x...xx.
....x.x......x.xx.
.xx.x......x.x....
.xx...x........xx.
.xx.x.x.x.xx.x.xx.
....x.............
.xx.x.x.xx.xxx.xx.
.xx...............
.xx.x.xx.xxx.xxxx.
.xx.x.xx.xxx.xxxx.
..................
ENDMAP

NAME:   minmay_quadrilaterals
TAGS:   transparent
WEIGHT: 1
DEPTH:  D:2-
SUBST:  x : x:40 cvbm
MAP
.....................
..xxxx+xxxxxxx+xxxxx.
.xxx.....xxx.....xxx.
.xxxx.....xxx.....xx.
.x.xxx.....xxx.....x.
.x..xxx.....xxx....x.
.+...xxx.....xxx...+.
.x....xxxx+xxxxxx..x.
.x.....x.....x.xxx.x.
.xx....x.....x..xxxx.
.xxx...+..'..+...xxx.
.xxxx..x.....x....xx.
.x.xxx.x.....x.....x.
.x..xxxxxx+xxxx....x.
.+...xxx.....xxx...+.
.x....xxx.....xxx..x.
.x.....xxx.....xxx.x.
.xx.....xxx.....xxxx.
.xxx.....xxx.....xxx.
.xxxxx+xxxxxxx+xxxx..
.....................
ENDMAP

NAME:   minmay_puff
TAGS:   transparent
WEIGHT: 1
DEPTH:  D:2-
MAP
   xxxxx
xxxx...xxx
xx.......xx
x...xmx...xx
x..xx.xx...x
xx....xx...xxxxx
.xmxxmx...xx...xx
.........xx.....xx
@......xmx..xxx..x
....xmxx...xx...xx
xxmx........mxxxx
....xmxx...xx...xx
@......xmx..xxx..x
.........xx.....xx
.xmxxmx...xx...xx
xx....xx...xxxxx
x..xx.xx...x
x...xmx...xx
xx.......xx
xxxx...xxx
xxxxxxxx
ENDMAP

NAME:   minmay_fractal_squares_5
TAGS:   transparent
WEIGHT: 5
DEPTH:  D:2-
SUBST:  x : x:40 cvbm
MAP
        ...
        .x.
       .....
     ...xxx...
     .x.x.x.x.
   .....x.x.....
   .x.........x.
  .....xx.xx.....
...xxx.x...x.xxx...
.x.x...........x.x.
...xxx.x...x.xxx...
  .....xx.xx.....
   .x.........x.
   .....x.x.....
     .x.x.x.x.
     ...xxx...
       .....
        .x.
        ...
ENDMAP

NAME:   minmay_fractal_squares_diagonal_5
TAGS:   transparent
WEIGHT: 5
DEPTH:  D:3-, Depths
MAP
... ... ... ...
.x...x. .x...x.
..xxx.. ..xxx..
 .x.x.   .x.x.
..xx+.....+xx..
.x...xx+xx...x.
... .x...x. ...
    .x...x.
... .x...x. ...
.x...xxxxx...x.
..xx+.....+xx..
 .x.x.   .x.x.
..xxx.. ..xxx..
.x...x. .x...x.
... ... ... ...
ENDMAP

NAME:    minmay_mirror_moons_of_madness
TAGS:    transparent
DEPTH:   D, Depths
WEIGHT: 3
SHUFFLE: ccvvbb
MAP
     ........
   ...cncncn...
  ..ncncncncnc...
 ..ncnc....ncncn.
 .ncn........cnc.
..cn...nbnb...cn..
......nbnbnb..ncn.
.....nb....nb..nc.
.....bn........cn.
.....nb........nc.
.....bn....bn..cn.
......bnbnbn..cnc.
..nc...bnbn...nc..
 .cnc........ncn.
 ..cncn....cncn..
  ..cncncncncn..
   ...ncncnc...
     ........
ENDMAP

NAME:   minmay_between
TAGS:   transparent
DEPTH:  D:2-
MAP
 .......
..x...x..
.xxx.xxx.
...xxx...
.xxx.xxx.
..x...x...
 ...x...x..
  .xxx.xxx.
  ...xxx...
  .xxxxxxx.
  ..x...x..
   .......
ENDMAP

NAME:    minmay_pentomino_pile
TAGS:    transparent
DEPTH:   D:2-4
MAP
   ............
   ....xxx.....
   .xx.x.x.xxx.
....x.x...xx...
..x.x.xx.x..x..
..x.x.x.xxx.xx...
..xx..x..x..xx...
..x.xx.x..xx..xx.
.x...x.xxx.xx.xx.
.xx.xx...x.x..x..
..xx..xxx...xx...
....x..x.xxx...
   .xx.x.x.....
   ..xx..x...
   ..........
ENDMAP
