##############################################################################
#
# Bailey! (Zaba and dpeg)
#
# A small portal vault fixated on nasty weapons. (Axes and polearms by now.)
# Castle like layout, with inner bailey and moat. Medieval warfare themed.
#
# Currently, the depth is fixed at D:7-10
#
##############################################################################

{{
function bailey_portal(e, ptype)
  local timeout_turns = crawl.random_range(600, 800)

  local messager =
    timed_msg {
      initmsg = { "You hear the roar of battle.",
                  "There is an entrance to a bailey on this level. "
                  .. "Hurry and find it before the portal closes forever!" },
      finalmsg = "$F{The} has been lowered almost to the ground.",

      verb = 'creaking',
      noisemaker = 'portcullis',
        ranges = {
          { 5000, 'faint ' },  { 4000, '' },
          { 2500, 'steady ' }, { 1500, 'quick ' },
          { 0, 'loud ' }
      }
    }

  dgn.persist.bailey_type = "bailey_" .. ptype

  e.lua_marker('O',
      timed_marker {
        disappear = "The portal closes with a thud.",
        entity = 'portcullis',
        bailey_type = ptype,
        turns = timeout_turns,
        single_timed = true,
        floor = "stone_arch",
        feat_tile = "dngn_portal_bailey_gone",
        msg = messager })
  e.tags("uniq_bailey chance_bailey")
  e.chance(1000)

  e.kfeat("O = enter_bailey")
  e.tile("c = wall_stone_smooth")
end

function bailey_portal_axe(e)
  bailey_portal(e, 'axe')
end

function bailey_portal_polearm(e)
  bailey_portal(e, 'polearm')
end

-- colours
function bailey_setup(e)
  e.kfeat("< = exit_bailey")
end

-- In order to avoid repeating the lengthy monster definitions:

-- Axes.
function axe_returning(e)
  e.mons("generate_awake kobold")
end

function kobold_axe_returning(e)
  e.mons("generate_awake kobold")
end

function easy_axe_fighter(e)
  e.mons("orc warrior")
end

function hard_axe_fighter(e)
  e.mons("orc warrior")
end

function orc_warlord_with_axe(e)
  e.mons("orc warlord")
end

-- Polearms.
function orc_with_polearm(e)
  e.mons("orc")
end

function orc_warrior_with_polearm(e)
  e.mons("orc warrior")
end

function orc_knight_with_polearm(e)
  e.mons("orc knight")
end

function orc_warlord_with_polearm(e)
  e.mons("orc warlord")
end

}}

# Basic bailey entries ##########################################
default-depth: D:7-10

NAME: enter_bailey_1
TAGS: transparent
WEIGHT: 1
: local rnd = crawl.random2(2)
: if rnd == 0 then
:   bailey_portal_axe(_G)
: elseif rnd == 1 then
:   bailey_portal_polearm(_G)
: end
MAP
O
ENDMAP

NAME: enter_bailey_2
TAGS: transparent
: local rnd = crawl.random2(2)
: if rnd == 0 then
ITEM: hand axe
:   bailey_portal_axe(_G)
: elseif rnd == 1 then
ITEM: halberd / spear
:   bailey_portal_polearm(_G)
: end
MAP
.....
..d..
.dOd.
..d..
.....
ENDMAP

NAME:   enter_bailey_6
TAGS:   transparent
WEIGHT: 3
COLOUR: ; : red / lightred
SUBST:  ; = .
KMASK:  d = no_item_gen
KMASK:  d = no_monster_gen
KPROP:  d = no_tele_into
: local rnd = crawl.random2(2)
: if rnd == 0 then
:   set_feature_name("granite_statue", "granite statue wielding a mighty axe")
    TILE: G = dngn_statue_axe
:   bailey_portal_axe(_G)
: elseif rnd == 1 then
:   set_feature_name("granite_statue", "granite statue wielding a fearsome trident")
    TILE: G = dngn_statue_polearm
:   bailey_portal_polearm(_G)
: end
MAP
.....G.....
..G.....G..
...........
....;;;....
G...;O;...G
....;;;....
...........
..G.....G..
.....G.....
ENDMAP

NAME:   enter_bailey_8
WEIGHT: 3
COLOUR: n = red
KMASK:  d = no_item_gen
KMASK:  d = no_monster_gen
KPROP:  d = no_tele_into
: local rnd = crawl.random2(2)
: if rnd == 0 then
:   set_feature_name("granite_statue", "granite statue wielding a mighty axe")
    TILE: G = dngn_statue_axe
:   bailey_portal_axe(_G)
: elseif rnd == 1 then
:   set_feature_name("granite_statue", "granite statue wielding a fearsome trident")
    TILE: G = dngn_statue_polearm
:   bailey_portal_polearm(_G)
: end
MAP
 xxxxxxxxxxx
 x.........@
 ccccGcccGcc
@+........OG
 ccGcccGcccc
 x.........@
 xxxxxxxxxxx
ENDMAP

# The actual portal vaults #####################################
default-depth:

NAME:   bailey
TAGS:   allow_dup
PLACE:  Bailey
ORIENT: encompass
{{
  local btype = dgn.persist.bailey_type
  if not btype then -- Wizmode
    if crawl.coinflip() then
      btype = "bailey_axe"
    else
      btype = "bailey_polearm"
    end
  end
  if crawl.game_started() then
    local map = dgn.map_by_tag(btype)
    assert(map, "Couldn't find a map for " .. btype)
    dgn.place_map(map, false, false)
  end
}}
MAP
ENDMAP

##########
#        #
#  AXES  #
#        #
##########

NAME:   bailey_axe_minmay_hex_keep
ORIENT: encompass
TAGS:   bailey_axe no_item_gen no_monster_gen
# Loot consists of 8 good potions and scrolls in the last outer room, with a
# lot of gold and especially good items in the (very dangerous) center room.
#
# I believe that loot is a bit much, but other baileys suffer from that as
# well... added the warlord in an attempt to make it more even.  --dpeg
: item(dgn.loot_scrolls .. " / " .. dgn.loot_potions)
ITEM:   potion of experience ident:type q:1 /\
        scroll of acquirement ident:type q:1
: easy_axe_fighter(_G)
: hard_axe_fighter(_G)
: orc_warlord_with_axe(_G)
: bailey_setup(_G)
SUBST:  I = t., 1 = 11.
NSUBST: 2 = 3:2 / *=2.
MAP
ttttttttttttttttttttttttttttttttttttt
ttttttttttttttttttttttttttttttttttttt
tttttttttttttttcccccccttttttttttttttt
ttttttttttttttccdd<ddcctttttttttttttt
ttttttttttttttcdd2.2ddctttttttttttttt
tttttttttttttcc.......ccttttttttttttt
tttttttttttttc.........cttttttttttttt
ttttttttttttcc.1.....1.cctttttttttttt
ttttttccccccc2...1T1...2ccccccctttttt
tttttcc1.2.1cc.1.....1.cc1.2.1ccttttt
tttttc.......+....2....+.......cttttt
ttttcc.......cc.1...1.cc.......cctttt
ttttc.........c.......c.........ctttt
tttcc...1.1...ccGG.GGcc...1.1...ccttt
tttc2....T....1ccc+ccc1....T....2cttt
tttcc...1.1...ccc...ccc...1.1...ccttt
ttttc.........c1.....1c.........ctttt
ttttcc.......cc..1.1..cc.......cctttt
tttttc.......c2.......2c.......cttttt
tttttcc1...1cc..1...1..cc1...1ccttttt
ttttttcc+cccc.....3.....cccc+cctttttt
tttttcc.....cc..1...1..cc.....ccttttt
tttttc1.....1c2.......2c1.....1cttttt
ttttcc.......cc.......cc.......cctttt
ttttc1.......1c|$$$$$|c1.......1ctttt
tttcc.........cc$$e$$cc.........ccttt
tttc2....T....1ccccccc1....T....2cttt
tttcc.........cc1.1.1cc.........ccttt
ttttc1.......1c.......c1.......1ctttt
ttttcc.......cc1.....1cc.......cctttt
tttttc1......+.........+......1cttttt
tttttcc.....cc.........cc.....ccttttt
ttttttccccccc.....T.....ccccccctttttt
ttttttttttttcc.........cctttttttttttt
tttttttttttttc.........cttttttttttttt
tttttttttttttcc.......ccttttttttttttt
ttttttttttttttc.......ctttttttttttttt
ttttttttttttttcc.....cctttttttttttttt
tttttttttttttttcc+++ccttttttttttttttt
ttttttttttttttI.......Itttttttttttttt
ttttttttttttttI.......Itttttttttttttt
tttttttttttttI....<....Ittttttttttttt
tttttttttttttI.........Ittttttttttttt
tttttttttttttI....A....Ittttttttttttt
tttttttttttttI.........Ittttttttttttt
ttttttttttttttII.....IItttttttttttttt
ttttttttttttttttIIIIItttttttttttttttt
ttttttttttttttttttttttttttttttttttttt
ttttttttttttttttttttttttttttttttttttt
ENDMAP

##############
#            #
#  POLEARMS  #
#            #
##############

############################################################################
# A polearm bailey.
#
# Loot consists of three items, among them one piece of good heavy body
# armour and another piece of good additional armour. Apart from what the
# orcs leave lying around.
#
NAME:   bailey_polearm_1
ORIENT: encompass
TAGS:   bailey_polearm no_rotate no_pool_fixup no_monster_gen
NSUBST: D = 1:+ / *:c
NSUBST: E = 1:+ / *:c
: orc_with_polearm(_G)
: orc_warrior_with_polearm(_G)
: orc_knight_with_polearm(_G)
SUBST:  2 = 22223..
SUBST:  1 = 1 2:1 .
ITEM:   good_item crystal plate armour / good_item plate armour w:20 /\
        good_item gold dragon scales w:3 / good_item ice dragon scales w:3 /\
        good_item fire dragon scales w:3 / good_item storm dragon scales w:3 /\
        good_item shadow dragon scales w:3
ITEM:   good_item cloak / good_item pair of gloves /\
        good_item helmet / good_item pair of boots /\
        good_item tower shield / good_item kite shield
: bailey_setup(_G)
MAP
xxxxxxxxxxxxxxxxxxxxxxxxxxxxxxxxxxx
xA<xxxxxxxxxx.........xxxxxxxxxxxxx
xx..xxxxxxxx..WWWWWWW..xxxxxxxxxxxx
x..xxxxxxxx..WW.1.1.WW..xxxxxxxxxxx
xx..xxxxxx..WW..ccc..WW..xxxxxxxxxx
x..........WW.1cc.cc1.WW..........x
x.WWWWWWWWWW..ccd|ecc..WWWWWWWWWW.x
x.W1..1..1..1cc.....cc1..1..1..1W.x
x.W.ccncccccccccc+ccccccccccncc.W.x
x.W1cc.$$$.cc.........cE....2cc1W.x
x.W..nc.$.cc..lll.lll..EE...cn..W.x
x.WW1.cc.cc..ll..2..ll..Ec.cc.1WW.x
x<.WW..c+c..ll2..T..2ll..c+c..WW.xx
xx.WW..c+c......T<T......c+c..WW.<x
x.WW1.cc.cD..ll2...2ll..cc.cc.1WW.x
x.W..cc...DD..lllllll..cc.$.cc..W.x
x.W1cc2....Dc.........cc.$$$.cc1W.x
x.W.ccccccccccccc+ccc+ccccccccc.W.x
x.W1..1..1..1cc.....cc1..1..1..1W.x
x.WWWWWWWWWW..cc.<.cc..WWWWWWWWWW.x
x..........WW.1nc.cn1.WW..........x
xxxxxxxxxx..WW..ccc..WW..xxxxxxxxxx
xxxxxxxxxxx..WW.1.1.WW..xxxxxxxxxxx
xxxxxxxxxxxx..WWWWWWW..xxxxxxxxxxxx
xxxxxxxxxxxxx.........xxxxxxxxxxxxx
xxxxxxxxxxxxxxxxxxxxxxxxxxxxxxxxxxx
ENDMAP

# same loot as minmay_hex_keep, and a similar warlord fight
# slightly more of the loot is outside of the warlord's room
# the warlord fight is a little easier, and the outer fights are harder
NAME:   bailey_axe_bossmonster_kennysheep
ORIENT: encompass
TAGS:   bailey_axe no_item_gen no_monster_gen no_pool_fixup
: item(dgn.loot_potions .. " / " .. dgn.loot_scrolls)
ITEM:   potion of experience ident:type q:1 / \
            scroll of acquirement ident:type q:1
: easy_axe_fighter(_G)
: kobold_axe_returning(_G)
: hard_axe_fighter(_G)
: orc_warlord_with_axe(_G)
: bailey_setup(_G)
SUBST:  1 = 1.., 2 = 22.
NSUBST: 3 = 2:3 / * = 3.
NSUBST: e = 1:e / *:d
MAP
      ccccc         ccccc
     ccd$1cc       cc1$dcc
    ccd...1cc     cc1...dcc
   cc.......ccccccc.......cc
  ccd.G21G...31.13...G12G.dcc
  cd..23...............32..dc
  c$..1.................1..$c
  c...G......c===c......G...c
ttcc......cnncWWWcnnc......cctt
tttcc1....cWWWWWWWWWc....1ccttt
ttt2cc1...cW.G...G.Wc...1cc2ttt
ttt.1ccc+ccc.......ccc+ccc1.ttt
tt1..WWW.cWW.G...G.WWc.WWW..1tt
tt...WWW.cW.........Wc.WWW...tt
t<.2.WWW.cW....<....Wc.WWW.2.<t
tt...WWW.cc..1...1..cc.WWW...tt
tt1..WWW.cW..G...G..Wc.WWW..1tt
ttt..ccc+cW.........Wc+ccc..ttt
ttt2cc1..cW|eG.4.Ge|Wc..1cc2ttt
tttcc....ccWWnnnnnWWcc....ccttt
ttcc......cccn...nccc......cctt
ttc21......1.......1......12ctt
ttc..G..G.............G..G..ctt
ttc21.....................12ctt
ttcc.......................cctt
ttwcc...G...cc+++cc...G...ccwtt
ttwwcc.....cc.....cc.....ccwwtt
ttwwwcc...cc.......cc...ccwwwtt
tttwwwccccc.........cccccwwwttt
ttttwwwwwww....A....wwwwwwwtttt
tttttwwwwww.........wwwwwwttttt
tttttttttttttt.<.tttttttttttttt
ttttttttttttttttttttttttttttttt
ENDMAP

# orcs are holding an elf hostage... but their prisoner isn't happy to see you.
# 6 gold piles, 4 good potions/scrolls, 4 good armours / superb items
NAME:   bailey_polearm_elven_captive_hellmonk
ORIENT: encompass
TAGS:   bailey_polearm no_item_gen no_monster_gen no_pool_fixup
: item(dgn.loot_potions .. " / " .. dgn.loot_scrolls)
ITEM:   any armour good_item no_pickup
: orc_with_polearm(_G)
: orc_warrior_with_polearm(_G)
: orc_knight_with_polearm(_G)
MONS: deep elf pyromancer / deep elf zephyrmancer w:5
SUBST:  1 = 1...
NSUBST: d = 2:$ / 4:d / * = e|
NSUBST: 2 = 2:2 / * = 2..., 3 = 1:3 / * = 2....
FTILE:  -t = floor_grass
: bailey_setup(_G)
MAP
  cccc        cccc
  c$3cccccccccc3$c
  c32..11...11.23c
  cc.11G2332G11.cc
   c.1ccn==ncc1.c
   c..cc....cc..c
   c11c..4...c11c
   c21n..cc..n12c
   c21n..cc..n12c
   c..cddddddc..c
   c..ccddddcc..c
xxxc..cccccccc..c
xxcc...G1..1G...cc
xxc11..........11c  tt
x-c$2cccc++cccc2$ctttt
--cccc--.22.--cccc--ww
--------....-------www
t----t--....------wwww
tttt---c1..1c---wwwwww
ttwwwwwc....cwwwwwwwww
wwwwwwwc....cwwwwwwwtt
wwwwwwwc....cwwwwww-t
wwwwwwwc....cwwww---t
www----c....c------tt
ww------....------tt
t--t-t--....-tt-
tt------....--t-
    ----....----
     --......--
     -........-
     t..A..<..t
     t........t
     tt......tt
      tttttttt
ENDMAP
