###
## Maps from named Wizards, unrand and fixedarts
#
#Wizard    |Threat                  |Loot                    |XP
#--------------------------------------------------------------------
#Doroklohe |constructs or demons    |scrolls or armour       |12000
#          |or top-tier undead      |or random               |
#--------------------------------------------------------------------
#Wucad Mu  |hell effect "monks",    |potions of experience,  |9000
#          |summoning OCS           |crystal ball of Wucad Mu|
#--------------------------------------------------------------------
#Cigotuvi  |uglies, abominations,   |tmut potions / books,   |16000
#          |lump shapeshifters      |scrolls of poison       |
#--------------------------------------------------------------------
#Iskenderun|DE mages, iood statues, |books, books, books,    |22000
#          |purple draconians       |robe of the archmagi    |
#--------------------------------------------------------------------
#Zonguldrok|skeletal warriors,      |consumables, gold,      |20000+
#          |zombies, ancient lich   |Zonguldrok's sword      |
#--------------------------------------------------------------------
#Golubria  |tloc-themed monsters,   |tloc items, cloaks,     |20000
#          |Abyss monsters          |abyss-escape aides      |
#--------------------------------------------------------------------
#Cloud Mage|air elementals,         |potions, robe of clouds,|24000
#          |wind drakes, Cloud Mage |speed/air-related misc  |
#--------------------------------------------------------------------
#Hellbinder|demons, summoners,      |fire/summoning/         |17000
#          |Hellbinder              |demonic items           |
#--------------------------------------------------------------------
#Lehudib   |earth-themed monsters,  |Moon Troll Leather Armour
#          |"space" themed abyss    |random loot and         |20000+
#          |monsters                |randbook of             |
#          |                        |earth/transmutations,   |
#          |                        |earth/translocations, or|
#          |                        |earth/conjurations
#--------------------------------------------------------------------
#Eringya   |plant monsters, archers |books, staves, potions  |
#          |and fenstrider witches  |spectral ego weapons    |
#--------------------------------------------------------------------
#Maxwell   |constructs and meaty    |gear with dangerous ego,|
#          |mace wielders           |weapon/armour artifacts |
#--------------------------------------------------------------------
#Yara      |Warrior-mages with      |antimagic weapons, books|
#          |antimagic weapons       |                        |
#--------------------------------------------------------------------
#Borgnjnor |Corporeal and ghostly   |necromancy loot, gold   |
#          |undead, warlocks        |                        |
#--------------------------------------------------------------------
#Tukima    |Dancing weapons,walking |aux armour, books,      |
#          |tomes, rakshashas       |phantom mirror          |
#--------------------------------------------------------------------
#Alistair  |Lots of wizards, invited|consumables, books,     |
#          |guests, ds corrupters   |condenser vane          |
##


#---------------------------------------------------------------------
#Full Name                |Layout               |Colours
#---------------------------------------------------------------
#Doroklohe's Tomb         |densely packed       |yellow walls,
#                         |collapsing tombs     |dark floor
#---------------------------------------------------------------
#Wucad Mu's Monastery     |empty temple         |dark walls,
#                         |                     |autumn trees
#---------------------------------------------------------------
#Cigotuvi's Fleshworks    |organic, irregular,  |magenta/red/yellow
#                         |twisted innards      |flesh/blood tiles
#---------------------------------------------------------------
#Iskenderun's Mystic Tower|fortress tower with  |tons of magenta
#                         |statues, cave corners|
#---------------------------------------------------------------
#Zonguldrok's Mausoleum   |tower, graveyard     |piles of darkgray
#---------------------------------------------------------------
#Roulette of Golubria     |old-abyss mess,      |mostly green,
#                         |teleport chambers maw|rare white or cyan
#---------------------------------------------------------------
#Cloud Mage's Chambers    |"cloud-esque"        |lightgray, white,
#                         |                     |lightblue
#---------------------------------------------------------------
#Hellbinder's Lair        |triangles and circles|red, darkgray,
#                         |sigils               |yellow sigils
#---------------------------------------------------------------
#Lehudib's Moon Base      |Circular and alien   |blue/lightblue/magenta
#                         |base-like structure  |colour-shifting crystal
#---------------------------------------------------------------
#Eringya's Formal Garden  |Gently curving open  |green with a chance for
#                         |paths hedged by trees|red/yellow autumn variant
#---------------------------------------------------------------
#Maxwell's Workshop       |big rooms with forge |metal
#---------------------------------------------------------------
#Yara's Duelist Academy   |campus               |stone and trees
#---------------------------------------------------------------
#Borgnjor's Mausoleum     |split path           |tarlike
#---------------------------------------------------------------
#Tukima's Studio          |mirrored hall        |lightgray/white
#---------------------------------------------------------------
#Alistair's Party Mansion |rooms                |gray/green/white
##

# TO-DO:
#
# Actual portals need quite a bit of editing, and some unique tiles.
# Tiles to fix: Doroklohe's plain floor, Cigotuvi's doorways, less generic
# Iskenderun tiles, Cloud Mage's "white fluffiness" and "sea of clouds".
#
##

{{
crawl_require("dlua/dungeon.lua")


function wizlab_portal (e)
    local timeout_turns = crawl.random_range(600, 800)

    local messager =
      timed_msg {
           initmsg = { "You hear the crackle of arcane power.",
                       "There is an entrance to a wizard's laboratory on "
                       .. "this level! Hurry and find it before the "
                       .. "portal closes forever!" },
        finalmsg = "The crackle of the magical portal is almost imperceptible now.",

        verb = 'crackle',
        noisemaker = 'magical portal'
    }

    e.lua_marker('O',
      timed_marker {
        disappear = "The flow of magic halts.",
        entity = 'portal',
        turns = timeout_turns,
        single_timed = true,
        floor = "stone_arch",
        feat_tile = "dngn_portal_bazaar_gone",
        msg = messager })
    e.kfeat("O = enter_wizlab")

    e.tags("uniq_wizlab vaults_wizlab no_item_gen no_monster_gen chance_wizlab")

    -- Replace stone walls with whatever wall type the Fortress level is using.
    if you.in_branch("Fortress") then
        e.subst("c = x")
    end

    e.chance(0)
    -- Don't apply the chance in Fortress, since we use a Fortress room for that
    -- branch.
    e.depth_chance("Fortress", 0)
end

-- Destinations:
function wizlab_setup (e)
    e.orient("encompass")
    e.tags("no_item_gen no_monster_gen")
    e.kfeat("< = exit_wizlab")
end

function wizlab_milestone (e, wizlab_desc)
    crawl.mark_milestone("br.enter", "entered " .. wizlab_desc .. ".", "parent")
    crawl.take_note("Entered " .. wizlab_desc)
    crawl.mpr("Welcome to " .. wizlab_desc .. "!")
end

}}

default-depth: Depths, Tower, Crypt, Fortress, !Fortress:$

###############################################################################
# Portal entrances.
#
# Todo: more, and better.
NAME:   mu_enter_wizlab_1
TAGS:   vaults_orient_s
TILE:   m = dngn_transparent_wall_green
COLOUR: m = lightgreen
:       wizlab_portal(_G)
MAP
    wwwww
   wwwwwww
  wwbmbmbww
 wwbb...bbww
wwbm..O..mbww
 wwbb...bbww
  wwbb+bbww
   www.www
    w.@.w
ENDMAP

###############################################################################

default-depth: WizLab

###############################################################################
# Iskenderun's Mystic Tower
#
# TODO: Could use more unique tiles.
#       A previous commit labeled this one as boring, though acceptable;
#       hopefully emphasizing the orbs and terrain more than previously
#       should help, though more unique contents could certainly be tried.
#
NAME:       wizlab_iskenderun
TAGS:       no_rotate patrolling
MONS:       tengu conjurer
MONS:       statue hd:12 spells:orb_of_destruction.62.magical \
            tile:mons_statue_mage col:vehumet name:conjurer n_adj
KMONS:      3DEF = purple draconian
KITEM:      D = robe ego:archmagi ident:type, star_item / superb_item, star_item
KITEM:      E = any book, randbook disc:conjuration owner:Iskenderun \
                spells:iskenderun's_mystic_blast&iskenderun's_battlesphere, \
                randbook disc:conjuration owner:Iskenderun
KITEM:      F = any book good_item, any book good_item, any book
KMONS:      DEF = purple draconian
KMONS:      H = purple draconian scorcher / purple draconian annihilator /\
                purple draconian knight / purple draconian stormcaller
COLOUR:     v = magenta
TILE:       v = dngn_metal_wall_magenta
MARKER:     " = lua:fog_machine { \
                pow_max = 10, delay_min = 10, delay_max = 40, \
                size = 15, cloud_type = "purple smoke" }
NSUBST:     1 = 4 = 1:1 3:19 / 6 = 1:2 3:3 / * = 1:15 ., H = 1:H / 1:H. / *:.
SHUFFLE:    '=F- / '=F- / '=F- / F-'= / F-'=, DEF
SUBST:      - = v, ' = ., = = +
LROCKTILE:  wall_zot_magenta
LROCKCOL:   lightmagenta
LFLOORTILE: floor_rough_magenta
LFLOORCOL:  magenta
:           set_random_mon_list("purple draconian / tengu conjurer")
:           wizlab_setup(_G)
epilogue{{
            wizlab_milestone(_G, "Iskenderun's Mystic Tower")
}}
MAP
vvvvvvvvvvvvvvvvvvvvvvvvvvvvvvvvvvvvvvvvv
vxxxxxxxxxxxxxxxxxxxxxxxxxxxxxxxxxxxxxxxv
vxxx..x.x.x.x.x.x.xx"xx.x.x.x.x.x.xx.xxxv
vxx<xxAx.x.x.x.x.x.x.x.x.x.x.x.x.x.xx.xxv
vx.x"xxx.x..........x.............xx"x.xv
vx.xx...............................xxxxv
vxxAx...............2...............x.xxv
vx.xx................................x.xv
vxx.......2.......v...v.......2.......xxv
vx.xx...........v.vv.vv.v............x.xv
vxx............vvv11.11vvv............xxv
vx.x..........v.v1vvvvv1v.v..........x.xv
vxx..........v.v1vvvEvvv1v.v..........xxv
vx.x........vvv1vvvv+vvvv1vvv........x.xv
vxx..........v1vvvH...Hvvv1v..........xxv
vx.x.......vv1vvvH......vvv1vv.......x.xv
vxxx........v1vvv.......vvv1v........xxxv
vx".x...2.....vD+.H.2...+'=.....2...x."xv
vxxx........v1vvv.......vvv1v........xxxv
vx.x.......vv1vvvH......vvv1vv.......x.xv
vxx..........v1vvvH...Hvvv1v..........xxv
vx.x........vvv1vvvv+vvvv1vvv........x.xv
vxx..........v.v1vvvFvvv1v.v..........xxv
vx.x..........v.v1vv-vv1v.v..........x.xv
vxx............vvv11.11vvv............xxv
vx.x............v.vv.vv.v............x.xv
vxx.......2.......v...v.......2.......xxv
vx.x.................................x.xv
vxx.x...............2...............x.xxv
vxxxx...............................xxxxv
vx.x"xx.............x.............xx"x.xv
vxx.xx.x.x.x.x.x.x.x.x.x.x.x.x.x.x.xx.xxv
vxxx.xx.x.x.x.x.x.xx"xx.x.x.x.x.x.xx.xxxv
vxxxxxxxxxxxxxxxxxxxxxxxxxxxxxxxxxxxxxxxv
vvvvvvvvvvvvvvvvvvvvvvvvvvvvvvvvvvvvvvvvv
ENDMAP
