#############################################################################
# elf.des: All maps and branch ending relating to the Elven Halls.
#
#  <<1>>   Arrival vaults
#  <<2>>   Decorative vaults
#  <<3>>   Monster-placing vaults
#  <<4>>   Elf:2 Hall of Blades entry vaults
#  <<5>>   Elf:2 Hall of Blades main vaults
#  <<6>>   End vaults
#
##############################################################################
##############################################################################

{{

crawl_require('dlua/vault.lua')

}}

NAME:    elf_arrival_001
ORIENT:  west
DEPTH:   Tower
SHUFFLE: asd/x$+
SHUFFLE: fgh/x$+
SUBST:   a = x, s = x, d = x, f = x, g = x, h = x
MAP
xxxxxxxxxxxxxxxaaa
xxxxxxxxxxxxxxxasa
xxxxxxxxxxxxxxxxdx
x...xxxxx........@
x.{........G..G..x
x...xxxxx........@
xxxxxxxxxxxxxxxxhx
xxxxxxxxxxxxxxxfgf
xxxxxxxxxxxxxxxfff
ENDMAP

##############################################################################

NAME:    elf_arrival_002
ORIENT:  south
DEPTH:   Tower
MAP
xxxxx@xxx@xxx@xxxxx
xxxx...........xxxx
xx....G.....G....xx
x.................x
x.G.............G.x
x.................x
x.......G.G.......x
x.................x
x.....G.....G.....x
xx...............xx
xxxx...........xxxx
xxxxxxxxxxxxxxxxxxx
ENDMAP

##############################################################################

NAME:    eino_elf_arrival_customs
ORIENT:  southwest
DEPTH:   Tower
MAP
xxxxxxxxx
x.+.....x
x.x..x..x
x.m.xxx.x
x.x..x..x
x.m.....x
x.x..x..x
x.m.xxx.x
x.x..x..x
x{m.....+
xxxxxxxxx
ENDMAP

##############################################################################

NAME:    eino_elf_arrival_shootout
ORIENT:  float
DEPTH:   Tower
MAP
xxxxxxxx@@@xxxxxxxx
xxxx...........xxxx
xx...............xx
x.................x
xxxx.....G.....xxxx
xxxxxxxx...xxxxxxxx
xxx......{......xxx
xxxxxxxx...xxxxxxxx
xxxx.....G.....xxxx
x.................x
xx...............xx
xxxx...........xxxx
xxxxxxxx@@@xxxxxxxx
ENDMAP

##############################################################################

NAME:   eino_elf_arrival_the_gate
ORIENT: south
DEPTH:   Tower
MAP
x.........x
@.........@
x.........x
x.........x
x.G.....G.x
x.........x
xxx+++++xxx
xxx.....xxx
xxx.....xxx
xxx.....xxx
xxx..{..xxx
xxxx...xxxx
xxxxxxxxxxx
ENDMAP

NAME:   minmay_elf_arrival_plus
ORIENT: float
DEPTH:   Tower
MAP
     x@...@x
     x.....x
     x..T..x
     x.....x
    xx.....xx
xxxxxmmm+mmmxxxxx
@....m.....m....@
.....m.....m.....
..T..+..{..+..T..
.....m.....m.....
@....m.....m....@
xxxxxmmm+mmmxxxxx
    xx.....xx
     x.....x
     x..T..x
     x.....x
     x@...@x
ENDMAP

NAME:   minmay_elf_arrival_summoners
ORIENT: float
DEPTH:   Tower
KFEAT:  m = iron_grate
MAP
  xxxxxxx
  x.....x
  x..{..x
xxx.....xxx
+.m.....m.+
xxx.....xxx
+.m.....m.+
xxx.....xxx
+.m.....m.+
xxx.....xxx
  x.....x
  x@...@x
ENDMAP

NAME:    nicolae_elf_arrival_aired_out
TAGS:    transparent
ORIENT:  float
DEPTH:   Tower
SHUFFLE: DEFH / JKLM
SUBST:   DM = m, E = {, F = T, H = +, JKL = .
MAP
          ..
xxxxxxxxxxHHx
x.ED..J..D..x
x..D..J..D..x
x.KJ..D..J..M.
x.LJ..D..J..M.
x..D..J..D..x
x.FD..J..D..x
xxxxxxxxxxHHx
          ..
ENDMAP

NAME:   nicolae_elf_arrival_dilemma
TAGS:   transparent
DEPTH:  Tower
WEIGHT: 5
ORIENT: float
SUBST:  T : TG
MAP
xxxxxxxxxxxxxxxxx
x.....xxTxx.....x
x.....+...+.....x
+.....+.{.+.....+
x.....+...+.....x
x.....xxTxx.....x
xxxxxxxxxxxxxxxxx
ENDMAP

NAME:   nicolae_elf_arrival_fired_up
TAGS:   transparent
DEPTH:  Tower
ORIENT: float
KFEAT:  2 = T
MAP
        .@.
bbbbbbbbnnnbb
b...........b
b..T..b..2..b
b.....n.....n.
b..{..n.....+@
b.....n.....n.
b..T..b..2..b
b...........b
bbbbbbbbnnnbb
        .@.
ENDMAP

##############################################################################
#
# <<2>> Decorative vaults.
#
##############################################################################

NAME:    nicolae_elf_glass_and_crystal_pillar_1
DEPTH:   Tower
TAGS:    transparent extra allow_dup
SHUFFLE: ab, bc
SUBST:   a = m, b : mb, c = b, _ : .._
CLEAR:   _
MAP
________
_......_
_.abba._
_.bccb._
_.bccb._
_.abba._
_......_
________
ENDMAP

NAME:    nicolae_elf_glass_and_crystal_pillar_2
DEPTH:   Tower
TAGS:    transparent extra allow_dup
SHUFFLE: ab, bc
SUBST:   a = m, b : mb, c = b, _ : .._
CLEAR:   _
MAP
_______
_....._
_.aba._
_.bcb._
_.aba._
_....._
_______
ENDMAP

NAME:    nicolae_elf_stair_hall
DEPTH:   Tower
TAGS:    extra
SUBST:   v : vb
SHUFFLE: {[(
MAP
    xxxxxxxxxxxxxxx
  xxxcccccccccccccx
 xxccc...........cx
 xcc....vv..vv..ccx
xxc....vv..vv..cccx
xcc...vv..vv..ccccx
xc...vv..vv.......@
xc.{..............@
xc...vv..vv.......@
xcc...vv..vv..ccccx
xxc....vv..vv..cccx
 xcc....vv..vv..ccx
 xxccc...........cx
  xxxcccccccccccccx
    xxxxxxxxxxxxxxx
ENDMAP

NAME:    nicolae_elf_stone_circles
DEPTH:   Tower
TAGS:    transparent allow_dup luniq
SHUFFLE: za, bd
SUBST:   a = A, b = B, zd = c
SHUFFLE: AB, DEFG
SUBST:   AD : +, BEFG = c, Z : GT. U:3, c : cx
MAP
      ccFcc
    Ecc...ccG
   cc.......cc
  Dc.....cczacc
 cc.....cc...ccc
 cdbc..cc.....cc
ccc.cccc.......cc
cc...cc.........c
A..Z..+....Z....B
cc...cc.........c
ccc.cccc.......cc
 cdbc..cc.....cc
 cc.....cc...ccc
  Dc.....cczacc
   cc.......cc
    Ecc...ccG
      ccFcc
ENDMAP

NAME:   nicolae_elf_v_pinch
DEPTH:  Tower
TAGS:   transparent extra allow_dup luniq_pinch
SUBST:  b : bc
NSUBST: L = @ / ., R = @ / .
MAP
xxxxxxxxx
bbxxxxxbb
LbbxxxbbR
L.bbxbb.R
L..bbb..R
L...b...R
L.......R
L.......R
L.......R
L...b...R
L..bbb..R
L.bbxbb.R
LbbxxxbbR
bbxxxxxbb
xxxxxxxxx
ENDMAP

NAME:   nicolae_elf_w_pinch
DEPTH:  Tower
TAGS:   transparent extra allow_dup luniq_pinch
SUBST:  b : bc
NSUBST: L = @ / ., R = @ / .
MAP
xxxxxxxxxxxxxxxxx
bbxxxxxbbbxxxxxbb
Lbbxxxbb.bbxxxbbR
L.bbxbb...bbxbb.R
L..bbb.....bbb..R
L...b.......b...R
L...............R
L...............R
L...............R
L...b.......b...R
L..bbb.....bbb..R
L.bbxbb...bbxbb.R
Lbbxxxbb.bbxxxbbR
bbxxxxxbbbxxxxxbb
xxxxxxxxxxxxxxxxx
ENDMAP

NAME:   nicolae_elf_m_pinch
TAGS:   transparent extra allow_dup luniq_pinch
DEPTH:  Tower
SUBST:  b : bc
NSUBST: L = @ / ., R = @ / .
MAP
xxxxxxxxxxxxxxxxx
xxxbbbxxxxxbbbxxx
xxbb.bbxxxbb.bbxx
xbb...bbxbb...bbx
bb.....bbb.....bb
b.......b.......b
L...............R
L...............R
L...............R
b.......b.......b
bb.....bbb.....bb
xbb...bbxbb...bbx
xxbb.bbxxxbb.bbxx
xxxbbbxxxxxbbbxxx
xxxxxxxxxxxxxxxxx
ENDMAP

NAME:    nicolae_elf_big_sculpture_1
TAGS:    transparent extra allow_dup
DEPTH:   Tower
SHUFFLE: abcdf
SUBST:   a : .
SHUFFLE: bcdef
SUBST:   bcd : v, e : .v, f : .v, v : vbcx
MAP
.........
.fda.adf.
.deb.bed.
.abc.cba.
.........
.abc.cba.
.deb.bed.
.fda.adf.
.........
ENDMAP

NAME:    nicolae_elf_big_sculpture_2
TAGS:    transparent extra allow_dup luniq
DEPTH:   Tower
SHUFFLE: mlk/mkl/nnn, abcdefghij
SUBST:   ka = ., nbcd = v, e : .v, f : .v, g : .v, h : .v, i : .v, j : .v
SUBST:   l : .v, m : .v, v : vbcx
MAP
  ...........
  .abcd.dcba.
....efg.gfe....
.a...hi.ih...a.
.be...j.j...eb.
.cfh.......hfc.
.dgij.klk.jigd.
......lml......
.dgij.klk.jigd.
.cfh.......hfc.
.be...j.j...eb.
.a...hi.ih...a.
....efg.gfe....
  .abcd.dcba.
  ...........
ENDMAP

NAME:    nicolae_elf_big_sculpture_3
TAGS:    transparent extra allow_dup luniq
DEPTH:   Tower
: if crawl.coinflip() then
SHUFFLE: bcegh
SUBST:   b = .
SHUFFLE: acdefghi
: else
SUBST:   f = v
SHUFFLE: abcdeghi
: end
SUBST:   acd = v, b : .v, e : .v, f : .v, g : .v, h : .v, i : .v
SUBST:   j : .v, v : vbcx
MAP
        .
       ...
      ..a..
     ..bcb..
    ..defed..
   ....ghg....
  ..d...i...d..
 ..beg.....geb..
..acfhi.j.ihfca..
 ..beg.....geb..
  ..d...i...d..
   ....ghg....
    ..defed..
     ..bcb..
      ..a..
       ...
        .
ENDMAP

NAME:    hangedman_elven_ridges
TAGS:    extra transparent
DEPTH:   Tower
WEIGHT:  1
MONS:    fungus
SHUFFLE: ABCD, EF, GHIJKLMN
SUBST:   A : x.., B : xx., CD = x, E : x.., F : x..
SUBST:   G : xxx., H : xxx., I : x., J : x., K : x:1 .:9, L : x:1 .:9
SUBST:   MN = ., c : c:16 b:2 v:1 1:1
MAP
   .cxBxc.
   .H...G.
   ...x......
......x......
cH..F.x.xxCxx
x.......J...I
A.xxx.c...x......
x.........x......
cG..xJ..E.x.xxDxx
....x.......L...K
  ..D.xxx.c...x..
  ..x.........x......
  ..xI..xL..F.x.xxAxc
      ..x.......N...M
      ..C.xxx.c...x..
      ..x.........x.
      ..xK..xN..E.x.
          ..x.......
          ..B.xxx.c.
          ..x.......
          ..cM.
ENDMAP

NAME:    hangedman_elven_pyramids
TAGS:    extra transparent
DEPTH:   Tower
WEIGHT:  1
SHUFFLE: ABCD, +-_, yz / yz / zy
SUBST:   A : ZZ., B : Z., C : Z.., D = .
SUBST:   + : x:9 +:2 .:1, -_ : x:9 z:1
SUBST:   Z : z:5 c:1 x:1 b:1, z : c:6 x:3 .:1
MAP
       ..x..
      ..x.x..
     ..x...x..
    ..x..A..x..
   ..x...y...x..
  ..x..xz.zx..x..
 ..x.x...y...x.x..
..x...zy.C.yz...x..
.x..B.yz...zy.D..x..
x.......x.x.......x..
xxxx+xxxx-x_xx-xxxx+xxxx
   ..x.......x.x.......x
    ..x..D.yz...zy.B..x.
     ..x...zy.C.yz...x..
      ..x.x...y...x.x..
       ..x..xz.zx..x..
        ..x...y...x..
         ..x..A..x..
          ..x...x..
           ..x.x..
            ..x..
ENDMAP

NAME:    hangedman_elf_targeted_burst
TAGS:    transparent extra
DEPTH:   Tower
SUBST:   x : xxc, Y : yycvb, y : xxcbv, z : cbv, Z = cbvwl
MAP
        x
   .x...y...x
   ..Y.xxx.Y.
   ...x...x..
   ..x.....x.
  xxyx..Z..xyx
 ....x.....x.
 .....z...x..
 ...xz.xxx.Y.
 ...zx..y...x
..xz....x....
..zx....x
xz......
zx..
ENDMAP

NAME:    hangedman_elf_simple_split
TAGS:    extra transparent
DEPTH:   Tower
MONS:    fungus
SHUFFLE: de, fg, hijk, CD
SUBST:   d : +., e : +x., f : +x., e : +.
SUBST:   h : +x, i : +x., i : +x., j : +x.
SUBST:   C : CTG1wl., D : ., x : x:90 cvb
KMASK:   wl = no_monster_gen
MAP
x..xx
x...xxxxxx
x...d....xxxxxx
xxx.e....h.....
xxxxx.CD.i....x
....f....j....x
....g....k.....
xxxxxxxxxx....x
....g....k.....
....f....j....x
xxxxx.CD.i....x
xxx.e....h.....
x...d....xxxxxx
x...xxxxxx
x..xx
ENDMAP

NAME:   nicolae_elf_glassroom_feature
TAGS:   transparent
DEPTH:   Tower
SHUFFLE: x_/m-
SUBST:   S = GT
CLEAR:   _
MAP
---__.__---
-mmxx.xxmm-
-m.......m-
_x..mxm..x_
_x.m...m.x_
...x.S.x...
_x.m...m.x_
_x..mxm..x_
-m.......m-
-mmxx.xxmm-
---__.__---
ENDMAP

NAME:    nicolae_elf_variegated_diamond
TAGS:    transparent
DEPTH:   Tower
KFEAT:   q = closed_clear_door
SHUFFLE: +cb/+cv/+cn/+cx/+bc/+bv/+bx/+bn/+vc/+vb/+vx/+vn/+xc/+xb/+xv/+xn/\
         qnc/qnb/qnv/qnx
MAP
.......b.......
.cb...bcb...cb.
.bc..bcbcb..bc.
....bcb.bcb....
...b+b...b+b...
..bcb.....bcb..
.bcb...c...bcb.
bcb...cbc...bcb
.bcb...c...bcb.
..bcb.....bcb..
...b+b...b+b...
....bcb.bcb....
.cb..bcbcb..cb.
.bc...bcb...bc.
.......b.......
ENDMAP

##############################################################################
#
# <<3>> Monster-placing vaults.
#
##############################################################################

NAME:   minmay_elf_crystal_pentagon
DEPTH:  Tower
ORIENT: float
WEIGHT: 1
MAP
   +bbbbbbbbbbb+
   b...........b
   b...........b
  bb...bbbbb...bb
  b...bb...bb...b
  b...b..U..b...b
 bb...bb...bb...bb
 b.....bb.bb.....b
 b...............b
bb..bb...........bb
+...b.....bbb.....+
bb..bbbb....b....bb
 bb....bb..bb...bb
  bbb...b..b..bbb
    bb.......bb
     bb.....bb
      bbb.bbb
        b+b
ENDMAP

NAME:   minmay_elf_crystal_hexagon
TAGS:   misc_elf_vault
DEPTH:  Tower
ORIENT: float
WEIGHT: 1
MAP
    +bbbbbbbbb+
    b....b....b
   bb....b....bb
   b....bbbb...b
  bb...bb......bb
  b....b........b
 bb....b...bb...bb
bb.....b....bb...bb
+............bb...+
bb...bb..U..bb...bb
 bb...bb...bb...bb
  b....bb.bb....b
  bb....bbb....bb
   b.....b.....b
   bb.bbbb....bb
    b.........b
    +bbbbbbbbb+
ENDMAP

NAME:   minmay_elf_crystal_heptagon
TAGS:   misc_elf_vault
DEPTH:  Tower
ORIENT: float
WEIGHT: 1
MAP
    +bbbbbbb+
   bb.......bb
   b.........b
  bb..bbbbb..bb
 bb...b...b...bb
bb...bb...bb...bb
+....b..U..b....+
b.b..b.....b.bb.b
b.bb.bb...bb..b.b
b.....bb.bb.....b
bb..........b..bb
 b.bb.....bbb..b
 b..b..b.......b
 +b....bbb....b+
  bbb.......bbb
    bbb...bbb
      bb+bb
ENDMAP

NAME:   minmay_elf_crystal_octagon
DEPTH:  Tower
ORIENT: float
WEIGHT: 1
MAP
     +bbbbb+
    bb.....bb
   bb..bb...bb
  bb.........bb
 bb...bbbbb...bb
+b....b...b....b+
b...bb..b..bb...b
b...b.......b.b.b
b...b.b.U.b.b.b.b
b.b.b.......b.b.b
b...bb..b..bb...b
+b....b...b....b+
 bb...bbbbb...bb
  bb.........bb
   bb..b.b..bb
    bb.....bb
     +bbbbb+
ENDMAP

NAME:   nicolae_elf_blasts_and_bolts
TAGS:   transparent
DEPTH:  Tower
WEIGHT: 1
SUBST:  E = x.
MAP
ccc..............ccc
ccc..cc..cc..cc..ccc
ccc..cc..cc..cc..ccc
...E......E.....E...
....................
.cc..xxx.x..xxx..cc.
.cc..xxx....xxx..cc.
.....xxxx..xxxx.....
.......xxxxxx.......
.ccE....xxxx..x..cc.
.cc..x..xxxx....Ecc.
.......xxxxxx.......
.....xxxx..xxxx.....
.cc..xxx....xxx..cc.
.cc..xxx..x.xxx..cc.
....................
...E.....E......E...
ccc..cc..cc..cc..ccc
ccc..cc..cc..cc..ccc
ccc..............ccc
ENDMAP

NAME:     infiniplex_blade_entry_pillars
DEPTH:    Tower
SUBST:    y : x...
MAP
      .
   xy---yx
   y..c..y
.  .......  .
....c...c....
.  .......  .
   y..c..y
   xy...yx
      .
      .
      .
      .
      .
     ...
ENDMAP

NAME:  nicolae_blade_entry_crossed_weapons
DEPTH: Tower
MAP
v.v.......v.v
.v...v-v...v.
v.v..vvv..v.v
...v..c..v...
......c......
.vv...c...vv.
..vcccccccv..
.vv...c...vv.
......c......
...v..c..v...
v.v..vvv..v.v
.v...v.v...v.
v.v.......v.v
ENDMAP

NAME: nicolae_blade_entry_diamond_columns
DEPTH:  Tower
SUBST: 1 = 1.., c : cv
MAP
.............
...c.....c...
..ccc...ccc..
.ccccc.ccccc.
..ccc...ccc..
...c.....c...
.............
...c.....c...
..ccc...ccc..
.ccccc.ccccc.
..ccc...ccc..
...c.....c...
.............
ENDMAP

NAME: nicolae_blade_entry_area_security
DEPTH:  Tower
SUBST: b : bc
MAP
...ccccccc...
.b.m.....m.b.
...c.....c...
.b.ccc+ccc.b.
...c.....c...
.b.+.....+.b.
...c.....c...
.b.c.....c.b.
...cc+++cc...
.b.........b.
.............
.b.b.b.b.b.b.
.............
ENDMAP

NAME: nicolae_blade_entry_pointy_end
DEPTH:  Tower
MAP
      @
vvvvvx.xvvvvv
v.vvvx.xvvv.v
v...vx.xv...v
vv.........vv
 v.........v
 vv.......vv
  v.......v
  vv.....vv
   v.....v
   vv...vv
    v...v
    vv.vv
     v@v
ENDMAP

NAME: nicolae_blade_entry_antechamber
DEPTH:  Tower
SUBST: A : xT
MAP
xxxxx.@.xxxxx
xxxxx...xxxxx
xxxxx...xxxxx
xxxx.....xxxx
xx....A....xx
x..A.....A..x
x...xbmbx...x
...xx...xx...
.A.b.....b.A.
...m.....m...
...b.....b...
...xx...xx...
@...xb+bx...@
      @
ENDMAP

NAME:  nicolae_blade_lattice
SUBST: b : bbbc, v : vvvm
DEPTH:  Tower
MAP
...b.....b...
..v-v...v-v..
.v---v.v---v.
b-----b-----b
.v---v.v---v.
..v-v...v-v..
...b.....b...
..v-v...v-v..
.v---v.v---v.
b-----b-----b
.v---v.v---v.
..v-v...v-v..
...b.....b...
ENDMAP

NAME:   dummy_elf_end
TAGS:   nolayout_halls
PLACE:  Tower:$
ORIENT: float
MAP
@..@
....
....
@..@
ENDMAP
