##############################################################################
# orc.des: Entries to the Armory, and (mini)vaults which appear _only_
#          in the Mines. General (mini)vaults, which can also appear in the
#          Mines, should go to vaults.des.
##############################################################################

##############################################################################
# Armory entries
##############################################################################
# Dummy Armory entry

NAME:   orc_0_dummy
TAGS:   orc_entry transparent
WEIGHT: 150
ORIENT: float
KFEAT:  O = enter_armory
MAP
O
ENDMAP

##############################################################################
# Freedom of Choice
#
NAME: david_orc_1_choice
TAGS: orc_entry
ORIENT: float
KFEAT: O = enter_armory
MAP
           xxx
        xxxxOxxxx
     xxxx.......xxxx
   xxx.............xxx
  xx....x.......x....xx
 xx....xxx.....xxx....xx
xx.....xxx.I.I.xxx..I..x
xx......x.......x......xx
x..x.x..x..x+x..x..x+x..x
x.xx.xx.x.xx.xx.x.xx.xx.x
x.x...x.x.x.e.x.x.x...x.x
x.x...x.x.x.e.x.x.x...x.x
x.xx.xx.x.xx.xx.x.xx.xx.x
x..x.x..x..x+x..x..x+x..x
x.......+.......+.......x
xx.....xxx.I.I.xxx..I..xx
 xx...xx xx...xx xx...xx
  x.@.x   xxxxx   x.@.x
ENDMAP

#######################
# Large temple
NAME:   minmay_orc_entry_temple_large
TAGS:   orc_entry
WEIGHT: 1
ORIENT: float
KFEAT:  _ = altar_beogh
KFEAT:  O = enter_armory
MAP
ccccc   ccccc
c'''c   c'''c
c'''c   c'''c
c'''c   c'''c
cc+ccccccc+cc
c"""""""""""c
c"""""""""""c
c"""""""""""c
c"""I"""I"""c
c"""""""""""c
c"""""_"""""c
c"""""""""""c
c"""I"""I"""c
c"""""""""""c
ccc"""""""ccc
ccc"""""""ccc
cccccc+cccccc
cccccI.Iccccc
ccccI...Icccc
cccI.....Iccc
   .......
   ...O...
   .......
ENDMAP

############################################################################
# (Mini)vaults specific to the Armory
############################################################################

default-depth: Armory

##################################
# Dummy Armory minivault balancer.
#
NAME: mines_dummy
TAGS: dummy
WEIGHT: 120
MAP
x
ENDMAP

###################################
# Beogh 1
NAME:   mines1_david
TAGS:   allow_dup transparent
KFEAT:  C = altar_beogh
WEIGHT: 20
MAP
...........
.xxxx.xxxx.
.xx.....xx.
.x.......x.
.x.......x.
.....C.....
.x.......x.
.x.......x.
.xx.....xx.
.xxxx.xxxx.
...........
ENDMAP

##################################################
# A temple (minmay)
#
NAME:   minmay_orc_temple_a
DEPTH:  Armory
KFEAT:  _ = altar_beogh
MAP
ccccccc
c..G..c
c.._..c
c.....c
ccc+ccc
 I...I
 .....
  ...
ENDMAP

##################################################
# Another temple (minmay)
#
NAME:   minmay_orc_temple_b
DEPTH:  Armory
KFEAT:  _ = altar_beogh
MAP
  ccccccc
  cI...Ic
  c.....c
  c.._..c
  c.....c
  cI...Ic
ccccc+ccccc
c.........c
c.c.....c.c
c.........c
c.c.....c.c
c.........c
c.c.....c.c
c.........c
c.c.....c.c
c.........c
c.c.....c.c
c.........c
cccc+++cccc
 ccI...Icc
  ..0....
   ...0.
    .0.
ENDMAP

#######################
# Yet Another Temple
NAME:   bh_open_orc_temple
TAGS:   transparent
DEPTH:  Armory
KFEAT:  _ = altar_beogh
MAP
     cccccccccc
 .............c
...I..I..I..I.c
.........""...cc
.........""...cc
..I..I..I""I'''c
........""""'''c
.I......""""'_'c
........""""'''c
..I..I..I""I'''c
.........""...cc
.........""...cc
..I...I..I..I.cc
 .............c
     cccccccccc
ENDMAP

NAME: nicolae_orc_crystal_geode
TAGS: no_item_gen no_trap_gen luniq_orc_cave
DEPTH: Armory
SUBST: B = b'
MAP
 xxxxxxxx
xx....xxxx
...x...bbxx
@xxxB...bbxx
 xbbB'''Bbxx
 xbB'''BBbxx
 xbbBBBBbbxx
 xxbbbbbbxx
  xxxxxxxx
ENDMAP

NAME: nicolae_orc_lava_room
TAGS: no_item_gen no_trap_gen luniq_orc_cave
DEPTH: Armory
SUBST: L = l., X = lx
MAP
   x.@xx
 xxx..xxx
xxx....Xxx
xX.....Llxx
xXLLLLLLlXx
xxllllllXxx
 xxXXXXXxx
  xxxxxxx
ENDMAP

NAME: nicolae_orc_lost_temple
TAGS: no_item_gen no_trap_gen luniq_orc_cave
DEPTH: Armory
NSUBST: D = + / c
SUBST: C = c.
KFEAT: _ = altar_beogh
MAP
 xxxxxx.
xxcccDCC.@
xxcI...I..
xxc.....Cx
xxD.._..Dxx
xxc.....cxx
xxcI...Icxx
xxcccDcccxx
 xxxxxxxxx
   xxxxx
ENDMAP

NAME: nicolae_orc_damp_corner
TAGS: transparent decor extra
DEPTH: Armory
SUBST: E = 1X, ' = ...WW11, X = xx.
KMONS: 1 = fungus / nothing w:3
KFEAT: 1 = W / . w:20
MAP
  x@@xx
  x..Xxxx
 xxX...Xxxxxxxx
 xxxXX...Xxxxxxxx
xxxxxxXX...'EExxxx
xxxxxxxxxX''''Exxxx
xxxxxxxxxx'''''Exxx
xxxxxxXXXX''''Exxx
 xxxXX....''EExxx
 xxX...XXxxxxxxx
  x..Xxxxxxxx
  x..Xxxxx
   @@xx
ENDMAP

NAME: nicolae_orc_lava_tube
TAGS: extra decor transparent
DEPTH: Armory
SUBST: X = xx., L = ll., Z = lx
MAP
                 xxxx@@@xx
           xxxxxxxxxZ...xxx
       xxxxxxxxxxxxxx...lZxx
    xxxxxZZZZxxxxxxxZ...llZx
  xxxxxxXLllllxxxxxZ...LllZx
 xxxxXXX...LLXXxxxxX...LlZxx
xxxxX....X.....XZxX...XXxxx
xZllL...XxZxx........Xxxxx
xZll...XxxxxllL.....Xxxxx
xZll..XXxxxxlllxZXXXxxx
xxxX...XxxxxZZxxxxxxxx
 xxxX...Zxxxxxxxxxxx
 xxxX...XXxxxxxxxx
  xxxZ...Xxxxxxx
   xxx@@@xxxx
ENDMAP

NAME: nicolae_orc_pool_cavern
TAGS: extra decor transparent
DEPTH: Armory
SUBST: W = ww., X = x:80 .:40 w
MAP
       xxx@@x
    xxxxxx..xx
   xxxxxxX..Xxx
  xxxxxxX...Xxxx
 xxxxXXX..Xxxxxx
 xxxX.......Xxxxx
xxxX..WWWW..Xxxxx
xxxX..WwwW.Xxxxxx
xxxX..WwwW.Xxxxxx
xxxX..WWWW..Xxxx
@.xX.........Xxx
@......XX.....Xxx
x.....XxxXX...Xxx
xxxxXXxxxxxX....@
 xxxxxxxxxxxX...@
   xxxxxxxxxxxxxx
      xxxxxxxxx
ENDMAP

NAME: nicolae_orc_stony_grotto
TAGS: extra decor transparent
DEPTH: Armory
SUBST: X = xxxc...., C = xc, D = ...c
MAP
  @Cxxxx
 @..xCcxxxx
 Cx...xxxxxxx
 xxC...CXXxxxx
 xxX..xx..DXxxx
xxxC..xD.c..XCxx
xxxX....cccD.Xxxx
xxC.c....c..ccxxx
xxXccc..D...ccXxx
xxxxc.Dcc.....Cxx
xxxxX..cc..C..XCx
 xxxxX....CC...xx
   xxxxXXXxxx..C
     xxxxxxxC..@
         xxxxC@
ENDMAP

############################################################################
# Armory endings.
#
# These generally place four random stores; particularly difficult endings
# might consider placing four good quality stores.
############################################################################

default-depth:

NAME:    orc_dummy_end
TAGS:    no_rotate no_item_gen transparent
PLACE:   Armory:$
ORIENT:  float
MAP
@..@
....
....
@..@
ENDMAP
