###############################################################################
# snake.des: All maps and branch endings relating to the Workshop Pit.
#
# <<1>>      Entries
# <<2>>      Decorative vaults
# <<3>>      Monster-placing vaults
# <<4>>      Workshop end vaults
#
###############################################################################
###############################################################################

###############################################################################
#
# <<1>> Workshop entries.
#       All must have the snake_entry tag and place an enter_snake feature.
#
###############################################################################

NAME:   dummy_snake_entry
TAGS:   snake_entry transparent
WEIGHT: 100
KFEAT:  O = enter_workshop
MAP
O
ENDMAP

NAME:   minmay_snake_entry_guardpost_small
TAGS:   snake_entry transparent
ORIENT: float
KFEAT:  O = enter_workshop
MAP
ccc.@.ccc
c.......c
c.......c
.........
@...O...@
.........
c.......c
c.......c
ccc.@.ccc
ENDMAP

NAME:   minmay_snake_entry_guardpost_medium
TAGS:   snake_entry transparent
WEIGHT: 5
ORIENT: float
KFEAT:  O = enter_workshop
MAP
   ccccccc
 ccc.....ccc
cc.........cc
c...c...c...c
@...c.O.c...@
c...c...c...c
cc.........cc
 ccc.....ccc
   ccccccc
ENDMAP

NAME:   minmay_snake_entry_guardpost_large
TAGS:   snake_entry transparent
WEIGHT: 2
ORIENT: float
KFEAT:  O = enter_workshop
MAP
c@ccccccc
c.......cc
c..c.c...cc
c.........cc
c..c.c.c...cc
c...........cc
cc...c.O.c...cc
 cc...........c
  cc...c.c.c..c
   cc.........c
    cc...c.c..c
     cc.......c
      ccccccc@c
ENDMAP

NAME:   nicolae_snake_entry_squirm
TAGS:   snake_entry patrolling transparent
KFEAT:  O = enter_workshop
MAP
xxxxxxxxxxxxxxx
xxxxxxxxxxxx.xx
xxx...xxxxx...x
x...T..xxx....@
x.O.....x...x.@
x...T......xxx@
xxx...x...xxxxx
xxxxxxxx.xxxxxx
xxxxxxxxxxxxxxx
ENDMAP

###############################################################################
#
# <<2>> Decorative vaults.
#
###############################################################################

default-depth: Workshop

NAME:    hangedman_snake_thin_pillar_pass
TAGS:    extra transparent
WEIGHT:  6
SHUFFLE: @' / @' / @' / '@
SUBST:   A : c.., B : c.., C : c.., D = cccc., E = c...., ' = .
: local Z = dgn.br_depth(you.branch())
: if crawl.x_chance_in_y(Z - you.depth(), Z) then
SUBST: c = x
: end
MAP
x@.xxxxxxxxx.@x
x......D......x
xx.cA..c..Ac.xx
 x.....D.....x
 xx.cB.c.Cc.xx
  x.........x
  xx.cC.Bc.xx
   x.......x
   xx.c.c.xx
    x.....x
    xx.E.xx
     x.'.x
ENDMAP

NAME:    hangedman_snake_wide_pillar_pass
TAGS:    extra transparent
WEIGHT:  4
SHUFFLE: @' / @' / @' / '@
SUBST:   A : c.., B : c.., C : c.., D = cccc., E : c...., F : c...., ' = .
: local Z = dgn.br_depth(you.branch())
: if crawl.x_chance_in_y(Z - you.depth(), Z) then
SUBST: c = x
: end
MAP
x.xxx.@.xxxxxxxxxxxxx.@.xxx.x
x...x.A......FDF......A.x...x
xxx...c.B.....c.....C.c...xxx
  xxx...c.C...c...B.c...xxx
    xxx...c.E...E.c...xxx
      xxx...c...c...xxx
        xxx...D...xxx
          xxx.'.xxx
ENDMAP

# Somewhat vaguely inspired by a vault shape in
# a draft of evilmike's for something else entirely.
NAME:    hangedman_snake_pattern
TAGS:    transparent extra
# Pillars, door positions, entrances.
SHUFFLE: XYZ, aA-+ / aA-+ / aA-+ / Aa+- / Aa+-, ABCDE
SUBST:   X : cx.., Y : cx...., Z = ., a = x, - : xx+, + : +++..
SUBST:   A : @@+, B : @@++..x, C : @+...xxx, DE = x
MAP
   xxBxxxxxxxCxxxxxxxDxxxxxxxxExxxxxx
  xx...xx.........xx...xx.........xx
 xx.....xx.......xx.....xx.......xx
aa...X...xx..Z..--...X...xx..Z..aa
 AA...Y...++..Y..++...Y...++..Y..AA
  xx...Z...--..X..xx...Z...--..X..xx
   xx.....xx.......xx.....xx.......xx
    xx...xx.........xx...xx.........xx
     xxExxxxxxDxxxxxxxxCxxxxxxBxxxxxxx
ENDMAP

NAME:   nicolae_snake_squiggles
TAGS:   transparent extra
NSUBST: a = x / ., p = x / ., q = x / ., D = x / ., E = x / ., F = x / .
NSUBST: r = x / ., H = x / ., s = x / ., J = x / ., K = x / ., L = x / .
NSUBST: M = x / ., N = x / ., O = x / ., P = x / ., Q = x / ., R = x / .
NSUBST: S = x / ., y = x / ., z = x / ., ' = x / ., " = x / ., - = x / .
MAP
     .......
    ..-x.xa..
   .."x-.axp..
  ..'x"...pxq..
 ..zx'.. ..qxD..
..yxz..   ..DxE..
.Sxy..     ..ExF.
.xS..       ..Fx.
....         ....
.xR..       ..rx.
.RxQ..     ..Hxr.
..QxP..   ..sxH..
 ..PxO.. ..Jxs..
  ..OxN...KxJ..
   ..NxM.LxK..
    ..Mx.xL..
     .......
ENDMAP

NAME:  nicolae_large_snake_swirl
TAGS:  transparent
: if you.depth() == 1 then
SUBST: s = ]})
: elseif you.depth() == dgn.br_depth(you.branch()) then
SUBST: s = [{(
: else
SUBST: s = ]})[{(
: end
MAP
xxxxxxxxxxx
@.........xxx
............xx
.............xx
..............x@......@x
..............xx.......x
...............x.......x
...............x.......x
.....xxxxx.....x......xx
...xxx.........x......x
..xx...........x......x
.xx...........xx.....xx
@x....xxxx....x......x
xx...xx......xx.....xx
x....x..s...xx.....xx
x....xx...xxx.....xx
x.....xxxxx......xx
x...............xx
x.............xxx
xx.........xxxx
 x.....xxxxx
 xx......@
  xx......
   xxx...@
     xxxxx
ENDMAP

NAME:  nicolae_coiled_stairwell_down
TAGS:  uniq_coiled_stairwell
DEPTH: Workshop, !Workshop:$
SUBST: } = }])>
MAP
  xxxxxxx
 xx.....xx
xx.xxxxx.xx
x.xx...xx.x
x.x.xxx.x.x
x.x.x}x.x.x
x.xx..x.x.x
xx.xxxx.x.x
 xx....xx.x
  xxxxxx.xx
    x...xx
   xx.xxx
   x.0.x
   x...x
   xx@xx
ENDMAP

NAME:  nicolae_coiled_stairwell_up
TAGS:  uniq_coiled_stairwell
DEPTH: Workshop:2-
SUBST: { = {[(<
MAP
  xxxxxxx
 xx.....xx
xx.xxxxx.xx
x.xx...xx.x
x.x.xxx.x.x
x.x.x{x.x.x
x.xx..x.x.x
xx.xxxx.x.x
 xx....xx.x
  xxxxxx.xx
    x...xx
   xx.xxx
   x.0.x
   x...x
   xx@xx
ENDMAP

NAME:   nicolae_snake_nest
TAGS:   transparent
ORIENT: float
MAP
         .........
    ......xx..xxx..
  ...xxxxxx..xx.xx..
.....x......xx...xx..
.xx..xx...............
..xx....xxxx..xxxx..x..
 ..x..xxx..x.....xx.xx..
 ..x..x....xx.x...x..x...
 ..x....xx....xx..x..xxx.
 .xx.xx.x......x.xx....x.
 .x..x..x..xxxxx.x.....x.
 .x..x..x.xx........x.xx.
 ....x..x....x..xxx.x....
 .xx.xx.xx...x.xx.x.xxx..
 .x...x..xxx.x....x...x.
 .xx..xx.....x....x.x.x.
 ..x...x.x...x..xxx.xxx.
  .xx....xxxxx..........
  ..x...........x..xx..
   .x.xxx...xxx.x..x..
   .x...xxxxx...x..x.
   .............xxxx.
     ..xx..xxxx......
      ..xxxx..x.
       .........
ENDMAP

NAME:  nicolae_snake_serpentine_hallways
TAGS:  transparent extra
MAP
        x@@@@xxxxx
        x........xxx
       xxx.........xx
    xxxxxxxx........x
xxxxxxxxxxxxxxxx....xx
@..............xx....x
@...............xx...x
xxxxxxxxxxx......x...x
xxxxx.....xxx...xx...x
xxx.........xx.xx....x
xx...........x+x....xx
xx....x+x...........xx
x....xx.xx.........xxx
x...xx...xxx.....xxxxx
x...x......xxxxxxxxxxx
x...xx...............@
x....xx..............@
xx....xxxxxxxxxxxxxxxx
 x........xxxxxxxx
 xx.........xxx
  xxx........x
    xxxxx@@@@x
ENDMAP

NAME:  nicolae_snake_linked_coils
TAGS:  transparent extra
SUBST: + : +x
MAP
    xxxxxxxxxxxxxx
  xxx.....xxx....xxx
 xx.........+x.....xx
xx...xxxxx...xxxx...xx
@...xxxx.+xx..xxxx...@
@..xxxxx..xx..xxxxx..@
xxxxxxx..xxxx..xxxxxxx
xxxxxxx..xxxx..xxxxxxx
xxxxxxx..xxxx..xxxxxxx
xxxxxxx..xxxx..xxxxxxx
xxxxxxx..xxxx..xxxxxxx
@..xxxxx..xx..xxxxx..@
@...xxxx...x+.xxxx...@
xx...xxxx...xxxxx...xx
 xx.....x+.........xx
  xxx....xxx.....xxx
    xxxxxxxxxxxxxx
ENDMAP

NAME: nicolae_snake_single_loop
TAGS: transparent extra
MAP
 xxxxxxx
xx.....xx
x.......xx
@...x...xxx
@..xxx..xxxx
xxxxxx..xxxxx
xx...+..+...xx
x....+..+....x
x...xx..xx...x
x..xxx..xxx..x
x...x...xx...x
x.......x....x
xx.....xx...xx
 xxxxxxxx@@xx
ENDMAP

NAME:    nicolae_snake_double_loop
TAGS:    transparent extra
SHUFFLE: AB, CD
SUBST:   AC = ., BD = +
MAP
 xxxxxxx    xxxxxxx
xx.....xxxxxx.....xx
x.......xxxx.......x
@...x...xxxx...x...x
@..xxx..xxxx..xxx..x
xxxxxxBBxxxxCCxxx..x
xx...A..A..D..D....x
x....A..A..D..D...xx
x...xxBBxxxxCCxxxxxx
x..xxx..xxxx..xxx..@
x...x...xxxx...x...@
x.......xxxx.......x
xx.....xxxxxx.....xx
 xxxxxxx    xxxxxxx
ENDMAP

NAME:    nicolae_snake_round_shape_thing
TAGS:    transparent extra
SHUFFLE: bc
SUBST:   a : x., b : x@, c : @
MAP
       xxbbbxx
     xxx.....xxx
    xx.........xx
    x...........x
   xx....xxx....xx
   x....xxxxx....x
   x...xxxxxxx...x
   x...xxxxxxx...x
  xx...xxxxxxx...xx
 xx.....xxxxx.....xx
xx.......xxx.......xx
c....a.........a....c
c...aaa.......aaa...c
c....a.........a....c
xx.......xxx.......xx
 xx.....xxxxx.....xx
  xx...xxxxxxx...xx
   x...xxxxxxx...x
   x...xxxxxxx...x
   x....xxxxx....x
   xx....xxx....xx
    x...........x
    xx.........xx
     xxx.....xxx
       xxbbbxx
ENDMAP

NAME:  nicolae_snake_biting_tails
TAGS:  transparent extra
SUBST: G : GT
MAP
xxxxx     xxxxxxx     xxxxxxx     xxxxxxx
@...xxxxxxx.....xxx xxx.....xxx xxx.....xxxxxxxx
xx....xx..........xxx.........xxx.........xx...x
 xxx.x......xxx....x....xxx....x....xxx..x.....x
   xx.G....xxxxxx.x...xxxxxxx.x...xxxxxxx.G....x
   xx.....xxxxxxxx...xxxxxxxxx...xxxxxxxx.....xx
   x....G.xxxxxxx...x.xxxxxxx...x.xxxxxx....G.xx
   x.....x..xxx....x....xxx....x....xxx......x.xxx
   x...xx.........xxx.........xxx..........xx....xx
   xxxxxxxx.....xxx xxx.....xxx xxx.....xxxxxxx...@
          xxxxxxx     xxxxxxx     xxxxxxx     xxxxx
ENDMAP

NAME:  nicolae_snake_slithery_corners
TAGS:  extra transparent
SUBST: D : TGG., E : TGG., F : TGG.
MAP
     ccc
c@@@ccccc@@@cc
c...ccccc...cccc
c...ccccc...ccccc
c....ccc....cccccc
cc....c....ccccccc
ccc...c...ccccccccc
ccc..DcF..ccccccccc
ccc...c...ccccc...@
cc....c....ccc....@
c....ccc..........@
c...cccc........ccc
cE..cccccc..F..ccccc
c...cccccccccccccccc
c....ccccc..D..ccccc
cc....ccc.......ccc
 c................@
 cc........ccc....@
  ccc..E..ccccc...@
    ccccccccccccccc
ENDMAP

NAME:  nicolae_snake_slithery_hallway
TAGS:  extra transparent
SUBST: D : TGG., E : TGG., F : TGG.
MAP
  cccccccccccccccccccccccccccccccccc
 cc..F..ccccc..D..ccccc..E..ccccc..@
cc.......ccc.......ccc.......ccc...@
@..................................@
@...ccc.......ccc.......ccc.......cc
@..ccccc..E..ccccc..D..ccccc..F..cc
cccccccccccccccccccccccccccccccccc
ENDMAP

NAME:   nicolae_snake_snake_lake
TAGS:   extra transparent
KMONS:  1 = plant
KFEAT:  1 = . w:40 / W
NSUBST: t = . / t
SUBST:  ' = 1 W .:60, t = t:80 1 . W:5
MAP
         .......   .......   .......
        .............................
    .....ttttttt...ttttttt...ttttttt..
   .....tt'''''tt.tt'''''tt.tt'''''tt..
  ..ttttt'''''''ttt'''''''ttt'''''''tt..
 ..tt'''''wwwww'''''wwwww'''''wwww'''t..
..tt'''''wwwwwww'''wwwwwww'''wwwwww''t..
..t'''wwwwwwwwwwwwwwwwwwwwwwwwwwwww''t..
..t''wwwwwwwwwwwwwwwwwwwwwwwwwwwww'''t..
..t''wwwwww'''wwwwwww'''wwwwwww'''''tt..
..t'''wwww''''.wwwww'''''wwwww'''''tt..
..tt'''''''ttt'''''''ttt'''''''ttttt..
 ..tt'''''tt.tt'''''tt.tt'''''tt.....
  ..ttttttt...ttttttt...ttttttt.....
   .............................
    .......   .......   .......
ENDMAP

# Although sometimes it's not a hallway.
NAME:  nicolae_snake_yet_another_twisty_hallway
TAGS:  extra transparent
: if crawl.one_chance_in(5) then
SUBST: x = -, . = x, @- = .
: end
SUBST: x : x:50 c:30 b, ' = .
MAP
xxxxxxxxxxxxxxxxxxxxxxxxxxxxxxxxxx
@'........xxx.....xxx...........xx
@..........x.......x.............x
xxxxxxxxx..x..xxx..x..xxxxxxxxx..x
xx....xxx..x..xxx..x..xx....xxx..x
x......xx..x..xx...x..x......xx..x
x..xx......x..x...xx..x..xx......x
x..xxx....xx..x..xxx..x..xxx....xx
x..xxxxxxxxx..x..xxx..x..xxxxxxxxx
x.............x.......x..........@
xx...........xxx.....xxx........'@
xxxxxxxxxxxxxxxxxxxxxxxxxxxxxxxxxx
ENDMAP

# https://www.youtube.com/watch?v=RmzgObMCicw
NAME:  nicolae_snake_flat_spine
TAGS:  transparent extra
DEPTH: Workshop
MAP
        .....................
    ......cc.cc.cc.cc.cc.cc....
......cc.c..c..c..c..c..c..cc...
..cc.c..c..c..c..c..c..c..c..cc.
..c..c..c..c..c..c..c..c..c..c..
cccccccccccccccccccccccccccccccc
..c..c..c..c..c..c..c..c..c..c..
..cc.c..c..c..c..c..c..c..c..cc.
......cc.c..c..c..c..c..c..cc...
    ......cc.cc.cc.cc.cc.cc....
        .....................
ENDMAP

################################################################################
# Gridmaze is a series of decor vaults inspired by the layout_grid_maze variant
# that have two-block-thick walls with rounded corners. The cleared notches
# around the outside edge give opportunities to connect up with the walls in
# the rest of the level.

NAME:    nicolae_snake_gridmaze_big_u
TAGS:    extra transparent
SHUFFLE: DEFHJ, KL/MN, KL, OPQRSZ, apqrsy, z-
SUBST:   DEFHKMz = x, JLNPQRSZpqrsy- = ., Oa = _
CLEAR:   _
MAP
.....OO..........yy.....
..xxxxxxxx----xxxxxxxx..
.xxxxxxxxxx--xxxxxxxxxx.
.xx......zz..zz......xx.
.xx......zz..zz......xx.
Pxx...x..zx--xxxxx...xxs
Pxx..xx..xx---xxxxx..xxs
.xx..xx..xx......xx..xx.
.xx..xx..xx......xx..xx.
.xx..xxLLxx..xNNNxx..xx.
.xx..KxLLxK..MxNNxM..xx.
Qxx..KK..KK..MM..MM..xxr
Qxx..KK..KK..MM..MM..xxr
.xx..KxLLxxxxxxNNxM..xx.
.xx..xxLLLxxxxNNNxx..xx.
.xx..xx..........xx..xx.
.xx..xx..........xx..xx.
Rxx..xxxxxxxxxxxxxx..xxq
Rxx...xxxxxxxxxxxx...xxq
.xx..................xx.
.xx..................xx.
.xxJJJHHHHFFFFEEEEDDDxx.
..xJJxxHHxxFFxxEExxDDx..
.....SS..ZZ..aa..pp.....
ENDMAP

NAME:    nicolae_snake_gridmaze_entwining
TAGS:    extra transparent
SHUFFLE: DE/FH, DE, JK, LM, NOPQRSZap
SUBST:   HDJL = x, FEKMOPQRSZap = ., N = _
CLEAR:   _
MAP
...PP..QQ..RR..SS..ZZ...
..xxxxxxxxxxxxxxxxxxxx..
.xxxxxxxxxxxxxxxxxxxxxx.
Oxx..................xxa
Oxx..................xxa
.xx...xxxxDDDDxxxxL..xx.
.xx..xxxxxxDDxxxxxM..xx.
Nxx..xx..EE..EE..MM..xxp
Nxx..xx..EE..EE..MM..xxp
.xxxxxx..ExDDxE..MxLLxx.
..xxxx...xxDDxx..xLLLLM.
.........xx..xx.........
.........xx..xx.........
.KJJJJx..xxFFxx...xxxx..
.xxJJxK..HxFFxH..xxxxxx.
pxx..KK..HH..HH..xx..xxN
pxx..KK..HH..HH..xx..xxN
.xx..KxxxxxFFxxxxxx..xx.
.xx..JxxxxFFFFxxxx...xx.
axx..................xxO
axx..................xxO
.xxxxxxxxxxxxxxxxxxxxxx.
..xxxxxxxxxxxxxxxxxxxx..
...ZZ..SS..RR..QQ..PP...
ENDMAP

NAME:    nicolae_snake_gridmaze_spiral
TAGS:    extra transparent
SHUFFLE: DE/FH/JK/LM/pq, DE, NO, PQRSZa
SUBST:   DFJLNp = x, EHKMOQRSZaq = ., P = _
CLEAR:   _
MAP
.................PP.....
.qxqqqxxxxLLLLxxxxxxxx..
.pxqqxxxxxxLLxxxxxxxxxx.
.pp..pp..MM..MM......xx.
.pp..pp..MM..MM......xx.
.pxqqxp..MxLLxxxxx...xxQ
.xxqqxx..xxLLLxxxxx..xxQ
.xx..xx..xx......xx..xx.
.xx..xx..xx......xx..xx.
.xxEExx..xxOOON..xxKKxx.
.DxEExD..NxOOxx..JxKKxJ.
.DD..DD..NN..xx..JJ..JJ.
.DD..DD..NN..xx..JJ..JJ.
.DxEExD..Nxxxxx..JxKKxJ.
.xxEExx..Oxxxx...xxKKxx.
.xx..xx..........xx..xx.
.xx..xx..........xx..xx.
axx..xxxxxFFFFxxxxx..xxR
axx...xxxxxFFxxxxx...xxR
.xx......HH..HH......xx.
.xx......HH..HH......xx.
.xxxxxxxxxxFFxxxxxxxxxx.
..xxxxxxxxFFFFxxxxxxxx..
.....ZZ..........SS.....
ENDMAP

NAME:    nicolae_snake_gridmaze_squiggle
TAGS:    extra transparent
: if crawl.one_chance_in(3) then
SUBST:   DHK = x, EFJ = .
: elseif crawl.coinflip() then
SUBST:   EHJ = x, DFK = .
: else
SUBST:   FJK = x, DEH = .
: end
SHUFFLE: LMNOPQRSZ
SUBST:   L = _, MNOPQRSZ = .
CLEAR:   _
MAP
...NN......OO......PP...
..xxxx....xxxx....xxxx..
.xxxxxx..xxxxxx..xxxxxx.
Mxx..xx..xx..xx..xx..xxQ
Mxx..xx..xx..xx..xx..xxQ
.xx..xxxxxx..xxxxxx..xx.
.xx...xxxx....xxxx...xx.
Lxx..................xxR
Lxx..................xxR
.xxx...EKKKKH...xxxxxxx.
..xxx..xxKKxJ..xxxxxxx..
.......HH..JJ..xx.......
.......HH..JJ..xx.......
..xxxxxxx..Jxxxxx..xxx..
.xxxxxxx...Dxxxx....xxx.
Rxx..................xxL
Rxx..................xxL
.xx...xxxx....xxxx...xx.
.xx..xxxxxx..xxxxxx..xx.
Qxx..xx..xx..xx..xx..xxM
Qxx..xx..xx..xx..xx..xxM
.xxxxxx..xxxxxx..xxxxxx.
..xxxx....xxxx....xxxx..
...PP......OO......NN...
ENDMAP

NAME:    nicolae_snake_gridmaze_swirls
TAGS:    extra transparent
SHUFFLE: DE, FH, JKLMNO
SUBST:   DF = x, EHKLMNO = ., J = _
CLEAR:   _
MAP
...NN..............MM...
..xxxxxxxx...xxxxxxxxx..
.xxxxxxxxxx...xxxxxxxxx.
Oxx......xx..........xxL
Oxx......xx..........xxL
.xxxxx...xxHHHxxxx...xx.
..xxxxx..FxHHxxxxxx..xx.
.....xx..FF......xx..xxK
.....xx..FF......xx..xxK
..xxxxx..Fxxxxxxxxx..xx.
.xxxxx...Hxxxxxxxx...xx.
Jxx..................xxJ
Jxx..................xxJ
.xx...xxxxxxxxE...xxxxx.
.xx..xxxxxxxxxD..xxxxx..
Kxx..xx......DD..xx.....
Kxx..xx......DD..xx.....
.xx..xxxxxxEExD..xxxxx..
.xx...xxxxEEExx...xxxxx.
Lxx..........xx......xxO
Lxx..........xx......xxO
.xxxxxxxxx...xxxxxxxxxx.
..xxxxxxxxx...xxxxxxxx..
...MM..............NN...
ENDMAP

NAME:    nicolae_snake_gridmaze_tees
TAGS:    extra transparent
SHUFFLE: DE/FH/JK/LM, DE, FH, JK, NOPQRSZ
SUBST:   DFJL = x, EHKMOPQRSZ = ., N = _
CLEAR:   _
MAP
...RR......QQ......PP...
..xxxxxxxxxxxxxMMMxxxx..
.xxxxxxxxxxxxxMMMxxxxxx.
Sxx..............LL..xxO
Sxx..............LL..xxO
.xxxxx....xxxxxxxxL..xx.
..xxxxx..xxxxxxxxxM..xx.
.....xx..xx..........xxN
.....xx..xx..........xxN
.DEEExx..xxxxxxxxxH..xx.
.xxEExD...xxxxxxxxF..xx.
Zxx..DD..........FF..xxZ
Zxx..DD..........FF..xxZ
.xx..Dxxxxxxxx...FxHHxx.
.xx..Exxxxxxxxx..xxHHHF.
Nxx..........xx..xx.....
Nxx..........xx..xx.....
.xx..Kxxxxxxxxx..xxxxx..
.xx..Jxxxxxxxx....xxxxx.
Oxx..JJ..............xxS
Oxx..JJ..............xxS
.xxxxxxKKKxxxxxxxxxxxxx.
..xxxxKKKxxxxxxxxxxxxx..
...PP......QQ......RR...
ENDMAP

NAME:    nicolae_snake_gridmaze_waves
TAGS:    extra transparent
SHUFFLE: DE, FH, JKLMNOPQ
SUBST:   DF = x, EHKLMNOPQ = ., J = _
CLEAR:   _
MAP
...NN......OO......PP...
..xxxxH...xxxx....xxxx..
.xxxxxF..xxxxxx..xxxxxx.
.xx..FF..xx..xx..xx..xx.
.xx..FF..xx..xx..xx..xx.
.xxHHxxxxxx..xxxxxx..xx.
.FHHHHxxxx....xxxx...xx.
.....................xxQ
.....................xxQ
..xxxxx.....xxxxx....xx.
.xxxxxxx...xxxxxxx...xx.
.xx...xx...xx...xx...xx.
.xx...xx...xx...xx...xx.
.xx...xxxxxxx...xxDDDxx.
.xx....xxxxx....EDDDDxE.
Mxx..................EE.
Mxx..................EE.
.xx...xxxx....xxxx...Ex.
.xx..xxxxxx..xxxxxx..xx.
.xx..xx..xx..xx..xx..xx.
.xx..xx..xx..xx..xx..xx.
.xxxxxx..xxxxxx..xxxxxx.
..xxxx....xxxx....xxxx..
...LL......KK......JJ...
ENDMAP

NAME:    nicolae_snake_gridmaze_zigzag
TAGS:    extra transparent
SHUFFLE: DE, FH, JK, LMNOP
SUBST:   DFJ = x, EHKMNOP = ., L = _
CLEAR:   _
MAP
.....LL..........MM.....
..xxxxxxxx....xxxxxxxx..
.xxxxxxxxxx..xxxxxxxxxx.
Pxx......xx..xx......xxN
Pxx......xx..xx......xxN
.xxHHxH..xxxxxx...xxxxx.
.FxHHxF...xxxx...xxxxx..
.FF..FF..........xx.....
.FF..FF..........xx.....
.FxHHxxxxxKKKKxxxxx...xO
.xxHHHxxxxxKKxxxxx...xxO
.xx......JJ..JJ......xx.
.xx......JJ..JJ......xx.
Oxx...xxxxxKKxxxxxEEExx.
Ox...xxxxxKKKKxxxxxEExD.
.....xx..........DD..DD.
.....xx..........DD..DD.
..xxxxx...xxxx...DxEExD.
.xxxxx...xxxxxx..ExEExx.
Nxx......xx..xx......xxP
Nxx......xx..xx......xxP
.xxxxxxxxxx..xxxxxxxxxx.
..xxxxxxxx....xxxxxxxx..
.....MM..........LL.....
ENDMAP

###############################################################################
#
# <<3>> Monster-placing vaults.
#
###############################################################################

NAME:   nicolae_snake_shapes
TAGS:   no_pool_fixup transparent
SUBST:  0 : TV
SUBST:  x : xcvmlwWb
MAP
      .....
   ...........
 ......xxx......
 .......0x.......
...xxx..xx..xxx...
....0x..x0...0x...
....xx..xxx..xx....
 ...x0...0x..x0....
 ...xxx..xx..xxx...
  .......x0.......
   ......xxx......
     ...........
        .....
ENDMAP

NAME:   nicolae_snakescales
ORIENT: float
MAP
        xxx       xxx       xxx
       x...x     x...x     x...x
      x.....x   x.....x   x.....x
   xxx.......xxx.......xxx.......xxx
  x...x.....x...x.....x...x.....x...x
 x.....x...x.....x...x.....x...x.....x
x.......xxx.......xxx.......xxx......x
 x.....x...x.....x...x.....x...x.....x
  x...x.....x...x.....x...x.....x...x
   xxx.......xxx.......xxx.......xxx
  x...x.....x...x.....x...x.....x...x
 x.....x...x.....x...x.....x...x.....x
x.......xxx.......xxx.......xxx......x
 x.....x...x.....x...x.....x...x.....x
  x...x.....x...x.....x...x.....x...x
   xxx.......xxx.......xxx.......xxx
  x...x.....x...x.....x...x.....x...x
 x.....x...x.....x...x.....x...x.....x
x.......xxx.......xxx.......xxx......x
 x.....x...x.....x...x.....x...x.....x
  x...x.....x...x.....x...x.....x...x
   xxx.......xxx.......xxx.......xx
      x.....x   x.....x   x.....x
       x...x     x...x     x...x
        xxx       xxx       xxx
ENDMAP

NAME: nicolae_snake_coiling_death
TAGS: transparent
MAP
       cccc  cccc  cccc
      cc..cccc..cccc..cc
    ..c....cc....cc....c
   ..c.....c.....c.....c.
  ..c.....c.....c.....c..
@..c.....c.....c.....c..@
..c.....c.....c.....c..
.c.....c.....c.....c..
 c....cc....cc....c..
 cc..cccc..cccc..cc
  cccc  cccc  cccc
ENDMAP

NAME:  nicolae_snake_snakewalk
TAGS:  transparent
MAP
     ccccccc         ccccccc
   ccc.....ccc     ccc.....ccc
  cc....G....cc   cc....T....cc
 cc...........cc cc...........cc
cc....ccccc....ccc....ccccc....cc
cc...ccccccc...ccc...ccccccc...cc
c...ccccccccc...c...ccccccccc...c@@@ ccc
c...cc.ccc.cc...c.G.cc|ccc*cc.G.c...cc.cc
c...+...c...+...c...+...c...+...c...+...c
cc.cc...c.G.cc*ccc|cc.G.c...cc.ccc.cc...c
 ccc @@@c...ccccccccc...c...ccccccccc...c
        cc...ccccccc...ccc...ccccccc...cc
        cc....ccccc....ccc....ccccc....cc
         cc...........cc cc...........cc
          cc....T....cc   cc....G....cc
           ccc.....ccc     ccc.....ccc
             ccccccc         ccccccc
ENDMAP

###############################################################################
#
# <<4>> Workshop ending vaults
#
###############################################################################

default-depth:

NAME:    snake_dummy_end
TAGS:    no_rotate
PLACE:   Workshop:$
ORIENT:  float
MAP
@..@
....
....
@..@
ENDMAP
