###############################################################################
# spider.des: All maps and branch endings relating to the Forge.
#
# <<1>>      Entries
# <<2>>      Decorative vaults
# <<3>>      Monster-placing vaults
# <<4>>      Forge end vaults
#
###############################################################################
###############################################################################

# Functions for the spider trap and endvault loot
{{
function setup_endvault_loot(e)
  e.item("potion of ambrosia ident:all")
  e.item(dgn.loot_potions)
  e.item("hat good_item w:20 / pair of gloves good_item / " ..
         "pair of boots good_item / scarf w:40 / orb w:40")
end
}}

###############################################################################
#
# <<1>> Forge entries.
#       All must have the spider_entry tag and place an enter_spider feature.
#
###############################################################################

NAME:   dummy_spider_entry
TAGS:   spider_entry transparent
KFEAT:  O = enter_forge
MAP
O
ENDMAP

###############################################################################
#
# <<2>> Decorative vaults.
#
###############################################################################

default-depth: Forge

NAME:   hangedman_spider_mandibles
TAGS:   extra transparent
# 59 inside blocks, 59 outside blocks.
NSUBST: x = 6:. / 9 = xx. / *:x
NSUBST: z = 4:. / 4:' / 9 = xxx''. / *:x
CLEAR:  '
MAP
      zzzzzzz
     zz.....zz
    zz...x...zz
    z...xxx...z
   zzx...x...xzz
  @z.x.......x.z@
 @z...xx...xx...z@
 z.....xx.xx.....z
 zx..xxx...xxx..xz
zz.x.x.......x.x.zz
z..xxx.......xxx..z
z..xx....x....xx..z
 z.x....xxx....x.z
z..x....xxx....x..z
z..xx....x....xx..z
zz..xx.......xx..zz
 zz.............zz
  zzzz..@.@..zzzz
ENDMAP

NAME: nicolae_spider_circle_web
TAGS: transparent extra
MAP
       ......x
     ...xxxxxx..
    ..xx.....xx..
   .xx......x..xx.
  .x....xxxxx....x.
 ..x...x....xx...x..
 .x...x....x..x...x.
xxx..x...xxx...x..x..
.x.xxx..x..xx...x..x.
.x..x.xxx.x..x..x..x.
.x..x..x.xxx.x..x..x.
.x..x..x..x.xxx.x..x.
.x..x...xx..x..xxx.x.
..x..x...xxx...x..xxx
 .x...x..x....x...x.
 ..x...xx....x...x..
  .x....xxxxx....x.
   .xx..x......xx.
    ..xx.....xx..
     ..xxxxxx...
       x......
ENDMAP

NAME:  nicolae_spider_webs_and_nodes
TAGS:  transparent extra
SUBST: D : .E, E : x .:5, F : .H, H : x .:5
MAP
             DDD
          ..DEEED
       .....DxxED
    ......xxxExED
 DDD...xxx...DDx..
DEEExxx.x......x..
DExxD....x.....x..
DExED....x......x..
 DDx.....xFF...xx..
 ..x....FHxHxxx.x..
 ..x....FxxxF....x..
  ..x.xxxHxHF....x..
  ..xx...FFx.....xDD
  ..x......x....DExED
   ..x.....x....DxxED
   ..x......x.xxxEEED
   ..xDD...xxx...DDD
    DExExxx......
    DExxD.....
    DEEED..
     DDD
ENDMAP

NAME:    nicolae_spider_stair_cavern
TAGS:
DEPTH:   Forge:2-
SHUFFLE: {[(
SUBST:   D = .x, . = .:100 ^:5
KFEAT:   ^ = web trap
MAP
  xxxxxxxxxx
 xxDDDDDDDDxxx
xxD.D...D.DDDxx
xD.D.DDD.D..DDxx
xDD.DDxDDDDD.DDxx
xD.DDDxxxxxDD.DDxx
xD.D.DDDDxxD.D.DDx
xDD.D...DDxDD.D..@
xxDDD.{..DxxDDDD.@
xDD.D...DDxDD.D..@
xD.D.DDDDxxD.D.DDx
xD.DDDxxxxxDD.DDxx
xDD.DDxDDDDD.DDxx
xD.D.DDD.D..DDxx
xxD.D...D.DDDxx
 xxDDDDDDDDxxx
  xxxxxxxxxx
ENDMAP

NAME:  nicolae_spider_checkerboard
TAGS:  transparent
SUBST: D = x:30 ., E = x .:30
MAP
.E.xxx.E.xxx.E.
E.ExxxE.ExxxE.E
.E.DxD.E.DxD.E.
xxD.E.DxD.E.Dxx
xxxE.ExxxE.Exxx
xxD.E.DxD.E.Dxx
.E.DxD.E.DxD.E.
E.ExxxE.ExxxE.E
.E.DxD.E.DxD.E.
xxD.E.DxD.E.Dxx
xxxE.ExxxE.Exxx
xxD.E.DxD.E.Dxx
.E.DxD.E.DxD.E.
E.ExxxE.ExxxE.E
.E.xxx.E.xxx.E.
ENDMAP

NAME:    nicolae_spider_spiderdrome
TAGS:    transparent
SHUFFLE: pqrsz/PQRSZ/FHJay/KLMNO
SUBST:   przs = ., q = x., PQKLFH = x, RMJD = xw, EZOy = w., SNa_ = x_
CLEAR:   _
MAP
__________sss__________
_xxxxxxxxxqpqxxxxxxxxx_
_xDDDDDDDDDrDDDDDDDDDx_
_xDEEEEEEEEzEEEEEEEEDx_
_xDE...............EDx_
_xDE...............EDx_
_xDE..EEEEEEEEEEE..EDx_
_xDE..EDDDDDDDDDE..EDQS
_xDE..EDxxxxxxxDE..ZRPS
_xDE..EDDDDDDDDDE..EDQS
_xDE..EEEEEEEEEEE..EDx_
_xDE...............EDx_
_xDE...............EDx_
_xDOEEEEEEEEEEEEEyEEDx_
_LMDDDDDDDDDDDDDDJDDDx_
NKLxxxxxxxxxxxxxHFHxxx_
NN______________aaa____
ENDMAP

NAME:  nicolae_spider_twisty_arc_passages
TAGS:  transparent
SUBST: D = x..
MAP
     ......   ........
    D...DD....D...DD......
   xxD.DxxD.DDxD.DxxDD.DDD.
  xxD..DxD.DxxxD..Dxxx.DxD.
 .DD..DxxD.DxDD....DDxDxxD.
 ...DDxxD..xxD..DDD.DxxxD..
 .DDxxxD..DxD..DxxxD.DxD..
.DxxxD....DxD.DxxDD..DxD.D
..DDD.xxD.DxD.DxD.....D..D
..DD..DxxDDxD..DD..DDDD...
.DxxD..DxxDxxD.DxDDxxxxDD..
 .DD..D.DD.xD..DxxxxDDDDxD.
 .DD.D.....D.DD.DxxD....D..
.DxxD..DDD.DDxxD.DxD.D..D..
..DxxDDxxxDxxxD........DxD.
.DxxxxxxDxxxDD.D..DDDDDxxD.
..DDxxD.DxD......DxxxxxxxD.
....DxxD.xxD.D..DxxDDDDDD.
.DDD.DxD.DxD..DDxxD....Dx
.DxD.DxD..D..DxxxD...Dxxx
 DxD..D.D..D..DDD..D..D
     .. ....  .......
ENDMAP

###############################################################################
#
# <<3>> Monster-placing vaults.
#
###############################################################################

# Misc minivaults
NAME:   guppyfry_spider_mini_1
MAP
x@.xxxxxxxx.
xx..xxxxx..@
xxx..xxx..xx
.xxx..x..xx.
@..xx...xx.@
xx.........x
xxx........@
xx..x...x.xx
x..xx..xx..x
@.xxx..xxx.@
xxxx..xxxxx.
xxx.@xxxxxxx
ENDMAP

NAME:   guppyfry_spider_mini_2
MAP
xx..xxxx..xx
x....xx....x
xx..xxxx..xx
xxx..xx..xxx
xWWxxWWxxWWx
@WWWWWWWWWW@
xWWxxWWxxWWx
xxx..xx..xxx
xx..xxxx..xx
x....xx....x
xx..xxxx..xx
ENDMAP

NAME:   guppyfry_spider_mini_3
MAP
W....WW....W
xW...WW...Wx
.xWWWWWWWWx.
.WxW.WW.WxW.
.W..WWWW..W.
WWWW....WWWW
.W..WWWW..W.
.WxW.WW.WxW.
.xWWWWWWWWx.
xW...WW...Wx
W....WW....W
ENDMAP

NAME:  nicolae_spider_jagged_tunnels
TAGS:  transparent
SUBST: D = x:75 .:20
MAP
..xxxxxxxxxx
...DDDDDDDDx
x.........Dx
xD..DDDDD.Dxxxx
xD.D.DxxD.DDDDx
xD.DDDxDD....Dx
xD.DxxxD.DDD.Dxxxx
xD.DxDDDDDxD.DDDDx
xD.DDD.DxxDD....Dx
xD....DDxxD.DDD.Dx
xDDDD.DxDDDDDxD.Dx
xxxxD.DDD.DxxxD.Dx
   xD....DDxDDD.Dx
   xDDDD.DxxD.D.Dx
   xxxxD.DDDDD..Dx
      xD.........x
      xDDDDDDDD...
      xxxxxxxxxx..
ENDMAP

NAME:  nicolae_spider_nooks_and_crannies
TAGS:  transparent
SUBST: D = x.
MAP
   ...........
  ...DDD.D.....
 ..DxDxDx.xD.D..
..Dxxxxxx.xxx...
.xxx..xxD..xxD...
...x..xxxx.DxxD..
.xxxx.x....xx....
.Dxx..x..xxxxxD..
.Dx..xxxxxD..xDD.
....xx..x....x.D.
.Dxxx...x.xxxx.D.
..DxD.xxx.....D..
..Dxx...xxxxxD..
 ..Dxxx.xDxDD..
  ..DDD.D.D...
   ..........
ENDMAP

NAME:   hellmonk_test_site
TAGS:   no_trap_gen ruin transparent
SUBST:  ' = x:4 .
SUBST:  G = G..
FTILE:  x.G1 = floor_sand
TILE:   x = wall_sandstone
TILE:   G = dngn_crumbled_column
MAP
     @
  xxx.xxx
 xxx...xxx
 xG.....Gx
 x.'''''.x
 x.'xxx'.x
 x.'xxx'.x
 x.'''''.x
 xG.....Gx
 xxx...xxx
  xxx.xxx
     @
ENDMAP

###############################################################################
#
# <<4>> Forge ending vaults
#
###############################################################################

NAME:   spider_dummy_end
PLACE:  Forge:$
WEIGHT: 20
ORIENT: float
MAP
@..@
....
....
@..@
ENDMAP
