###############################################################################
# swamp.des: All maps and branch endings relating to the Storage.
#
# <<1>>      Entries
# <<2>>      Decorative vaults
# <<3>>      Monster-placing vaults
# <<4>>      Storage end vaults
#
###############################################################################
###############################################################################

: crawl_require("dlua/dungeon.lua")

# Functionality for one of Grunt's vaults.
{{
function callback.grunt_lady_of_the_lake_trigger(data, triggerable, triggerer,
                                                 marker, ev)
  if data.triggered then
    return
  end

  local b = dgn.find_marker_positions_by_prop("merfolk_avatar_spawn", 1)[1]

  if dgn.create_monster(b.x, b.y, "generate_awake merfolk avatar") then

    data.triggered = true
    if you.see_cell(b.x, b.y) then
      crawl.mpr("A figure emerges from the depths of the water!", "warning");
    else
      crawl.mpr("The water ripples visibly.", "visual");
    end
  else
    crawl.mpr("The water ripples visibly.", "visual");
  end
end
}}

{{
function swamp_ruins(e)
    e.tags('serial_swamp_ruin extra transparent unrand')
    e.depth('Storage')
    e.weight('6')
    e.tile('x = wall_brick_vines')
    e.ftile('- = floor_sandstone')
    e.subst('- = .')
end
}}

###############################################################################
#
# <<1>> Storage entries.
#       All must have the swamp_entry tag and place an enter_swamp feature.
#
###############################################################################

# This is basically the dummy balancer.
NAME:   swamp_mist
TAGS:   swamp_entry transparent
KFEAT:  O = enter_storage
MARKER: O = lua:fog_machine { \
             pow_min = 8, pow_max = 12, delay = 25, \
             size = 2, walk_dist = 1, spread_rate= 33 }
MAP
O
ENDMAP

# Scenery, no threat.
NAME:   swamp_mist_pool
TAGS:   swamp_entry no_pool_fixup transparent
KFEAT:  O = enter_storage
SHUFFLE: XYZ
SUBST: Y : YX, Z : ZX, X = W, Y = w, Z = w
MARKER: O = lua:fog_machine { \
             pow_min = 8, pow_max = 12, delay = 25, \
             size = 2, walk_dist = 1, spread_rate= 33 }
SUBST:  '= t.., "= tw, t=ttw, A=Ww
MAP
       @
   't"Ywt@
  't"wYwXt'
 't"wAYXw"t'
 t"wwAOAZw"t
 't"wAAZw"t'
  't"wwZ"t'
   't"wt@
ENDMAP

###############################################################################
#
# <<2>> Decorative vaults.
#
###############################################################################

default-depth: Storage

###############################################################################
# A series of pools by Jude.
NAME:   swamp_pool1
TAGS:   no_pool_fixup allow_dup extra luniq_pool
WEIGHT: 1000
{{ smear_map({iterations=5, smear='w', onto='wwt"', boxy=false}) }}
SUBST:  "=ttw
MAP
     ""
   "www"
  "wwwww"
  wwwwwww"
  "wwwww"
   "www"
    "w"
ENDMAP

NAME:   swamp_pool2
TAGS:   no_pool_fixup allow_dup extra luniq_pool
WEIGHT: 500
SUBST:  "=ttttw
MAP
     ""
   "www"
  "wwwww"
  wwwwwww"
  "wwwww"
   "www"
    "w"
ENDMAP

NAME:   swamp_pool3
TAGS:   no_pool_fixup allow_dup extra luniq_pool no_exits
WEIGHT: 500
SUBST:  '=Wt, "=wwt
MAP
"'ttt'
'""w"tt
twwww"t
'""wwtt
 ttw"t'
  'tt'
ENDMAP

NAME:   swamp_pool4
TAGS:   no_pool_fixup allow_dup extra luniq_pool
WEIGHT: 500
SUBST:  "=ttttw
MAP
  t""tt
 ""www"t
"twwwwwtt
 wwwww"tt
"twww"tt"
 ttwww"tt
  ttw"tt
ENDMAP

NAME:   swamp_pool5
TAGS:   no_pool_fixup allow_dup extra luniq_pool no_exits
KMONS:  1 = patrolling swamp drake
KFEAT:  1 = deep_water
WEIGHT: 500
SUBST:  "=ttttw, '=ttW
MAP
  't't'
 tt"""t'
 t"w1w"tt
 ww1ww"t'
 t"w1t"t
 tt"w"ttt
  tt"t'
ENDMAP

###############################################################################
# Other Storage decorative vaults

# Storage's layout is chaotic and samey; fill it with decorative vaults.
NAME:   swamp_ruins_default
TAGS:   luniq_extradecor chance_extradecor allow_dup extra no_dump
PLACE:  Storage, !Storage:$
{{
  local n = 1
  hook("post_place", function()
    dgn.place_maps{tag="serial_swamp_ruin", count=n}
  end)
}}

NAME:   serial_swamp_ruin
TAGS:   luniq_serial luniq_extradecor chance_extradecor extra
PLACE:  Storage, !Storage:$
WEIGHT: 2
{{
  local n = 2 + crawl.random2(2)
  hook("post_place", function()
    dgn.place_maps{tag="serial_swamp_ruin", count=n}
  end)
}}

NAME:   swamp_other_decor
TAGS:   luniq_extradecor chance_extradecor allow_dup extra no_dump
PLACE:  Storage, !Storage:$
WEIGHT: 8
{{
  local n = 1
  hook("post_place", function()
    dgn.place_maps{tag="decor", count=n}
  end)
}}

#####
NAME: nicolae_swamp_fairy_circle
TAGS: transparent extra decor
SUBST: W = .W, w = wwwW, q = w
MONS: fungus / nothing w:7
MAP
    ...
  ..111..
 .11WWW11.
 .1WWwWW1.
.1WWwwwWW1.
.1WwwqwwW1.
.1WWwwwWW1.
 .1WWwWW1.
 .11WWW11.
  ..111..
    ...
ENDMAP

NAME: nicolae_swamp_treefoil
TAGS: transparent extra decor
SUBST: T = t.
KFEAT: . = . w:30 / W
MAP
tt       @     tt
 ttt....T.T...Tttt
  TtttT.TT..TtttT
  ..TttT...tttT.
   T..ttttttT..
    T..TTtT..T.
     @..TtT.T..
      T.TtT.TT.@
      ..TtT.TT
       .TtT.
        Tt.
        ttT
         t
ENDMAP

NAME: nicolae_swamp_feature_on_the_river_bank
TAGS: transparent no_pool_fixup decor
SUBST: T = t., W = .Ww t:5, Q = tw, f = .GTV U:5 C:5
MAP
     tttQ..@..Qttt
    ttQQQ.....QQQtt
tttttQQwW.....WwQQttttt
  ttQQwwW.....WwwQQtt
  ttQwwwW..f..WwwwQtt
   ttwwwW.....Wwwwtt
   @TwwwWW...WWwwwT@
   ..WwwwWWWWWwwwW..
   T..WwwwwwwwwwW..T
   tT..WwwwwwwwW..Tt
   ttT..WWWwWWW..Ttt
    ttT...WWW...Ttt
     ttT.......Ttt
      ttTTTTTTTtt
ENDMAP

NAME: nicolae_swamp_stair_fork
TAGS: extra decor
DEPTH: Storage:2-, !Storage:$
SHUFFLE: {}[]()
SUBST: W = w., T = t.
MAP
tttttt
t...TTtt
t.{...TTtt
t.......TTtt
tT..WWW...Ttt
tT..WwwW...Ttt
 tT.WwwwWW..Tt
 tT..WwwwwW..@
  tT..WwwwwW.
  tT..Wwwwww
   tT..Wwwww
   ttT..Www
    ttT..
     tt@
ENDMAP

NAME: nicolae_swamp_round_clearing
TAGS: transparent luniq_swclearing extra decor
SUBST: T = ttt.., E = .e, e = W.., t = ttttt.
MAP
    eeeee
   eEEEEEee
  eE.....EEe
 eE........Ee
eE..........Ee
eE...TTT.....Ee
eE...TtTT....Ee
eE...TTtT....Ee
eE....TTT...Ee
 eE........Ee
 eE........Ee
 eE.......Ee
  eE.....Ee
   eEEEEEe
    eeeee
ENDMAP

NAME: nicolae_swamp_rocky_clearing
TAGS: transparent luniq_swclearing extra decor
WEIGHT: 3
SUBST: X = xxxtt.., E = .e, e = W..
MAP
       eeeee
  eeeeeEEEEEeeeee
 eEEEEE....XEEEEEe
 eE.......XXX....Ee
eE...XXX...X......Ee
eE..XxxxX.....XX...Ee
eE..XxxxX....XxxX..Ee
eE...XXX......XX...Ee
 eE..............EEe
  eEEE...XX..EEEEee
   eeeEEEEEEEeeee
      eeeeeee
ENDMAP

NAME: nicolae_swamp_trees_clearing
TAGS: transparent luniq_swclearing extra decor
SUBST: w = Te, T = ttt.., E = .e, e = W..
MAP
      tttweeee
    wtttTwEEEEeee
  eeTtttT.....EEEe
eeEE.TttT........Ee
eE....TtT....T...Ee
eE....TtT...TtT...Ee
eE.....T....TtT...Ee
 eE........TttTT.Ee
  eE........TtttTEe
  eeEEE.....Ttttww
    eeeEEEEEwtttt
       eeeeewttt
ENDMAP

NAME:    hangedman_swamp_blocks
TAGS:    transparent extra no_pool_fixup decor
SHUFFLE: BC, DEF
SUBST:   A : ttw, B : tttww, D : w., E : w..., C = t, F = .
KMASK:   wW = no_monster_gen
MAP
  ...   ..    ..
 .WWW....WW....w.
.Wtttt..ttt.D.tAw
.WttttW.ttt.D.tt.
.WttttW.tBt......
 .ttttW.....ttt..
 ..WWW..FE..CttW.
 ......FE...tttW.
.Wttt.FE.WWW....
.WttB.E.Wtttt..
 .ttt...WttttW.
 .......WttttW.
 .DD.tCt.ttttW.
 ....ttt..WWW..
..tt.ttt......
.WAt..WW.
 .W.....
ENDMAP

NAME:    hangedman_swamp_diagram
TAGS:    transparent extra no_pool_fixup decor
MONS:    bush
SHUFFLE: AB, CD, EF, GH, IJ / IJ / JI
SUBST:   A : tww.., C : tww.., E : t., G = t.
SUBST:   I = wt1GT., BDF = t, H = .
KMASK:   wW = no_monster_gen
MAP
   tt.tt@tt@tt.tt
   tt.tt.tt.tt.tt
   tttWWttttWWttt
ttttttWWttttWWttt
tttttttA.tt.Btttt
..ttttttCWWDttttt
ttWWtttttWWtttttt
ttWWAttG.ttEtt
@.tt.Ct.I.Fttt
tttttWWt.JWttt
tttttWWtFWWttt
@.tt.DtEtttHtt
ttWWBttttttttt
ttWWtttttttttt
..ttttt
ttttttt
ttttttt
ENDMAP

NAME:   wheals_swamp_sinkhole
TAGS:   extra no_monster_gen decor
DEPTH:  Storage:1-2
WEIGHT: 5
KFEAT: ^ = shaft trap
SUBST: u = Ww
KPROP: wW^ = no_tele_into
MAP
ttttttttt
twwwwwwwt
twuuuuuwt
twuWWWuwt
twuW^Wuwt
twuWWWuwt
twuuuuuwt
@wwwwwwwt
ttttttttt
ENDMAP

NAME: nicolae_swamp_triple_paths
TAGS: transparent extra decor
SUBST: T = t_
CLEAR: _
MAP
         Tt@tT
         Tt.tT
     @TTTTt.tTTTT@
    T..tttt.tttt..T
    TT....t.t....TT
     Tttt.t.t.tttT
    TTttt.t.t.tttTT
TTTTTtttt.t.t.ttttTTTTT
ttttttttt.t.t.ttttttttt
TTTTTtttt.t.t.ttttTTTTT
    TTttt.t.t.tttTT
     Tttt.t.t.tttT
    TT....t.t....TT
    T..tttt.tttt..T
     @TTTtt.ttTTT@
        TTt.tTT
         Tt@tT
ENDMAP

NAME: nicolae_swamp_godswood
TAGS: transparent extra decor
MAP
ttt     ttt
..ttttttt..
@...ttt...@
.tt..t..tt.
tttt...tttt
 tt..t..tt
 t.......t
 tt..w..tt
  t.www.t
 tt..w..tt
 t...C...t
 tt..t..tt
  tt...tt
   ttttt
ENDMAP

NAME:    hangedman_swamp_cone
TAGS:    transparent extra no_pool_fixup decor
SHUFFLE: ABCDEF
SUBST:   AB : w, C : ww., D : w.., EF = ., G : ttw., H : wtt``, I : wtt``
CLEAR:   `
KMASK:   wW = no_monster_gen
MAP
t@......
t.ttttG.H
t.A.........
t....BttttG.H
t.tttttC.........
t.A.......DttttG.H
t....BttttttE.........
t.tttttC.......FttttG@
t.A.......Dtttttt.....
t....Btttttt......I
t.ttttt......I
t@......I
ENDMAP

NAME:    hangedman_swamp_lotus
TAGS:    transparent extra no_pool_fixup decor
MONS:    plant
SHUFFLE: ABCDE
SUBST:   AB : w, C : wwW1, D : wWW1, E : W1
KMASK:   wW = no_monster_gen
MAP
        ... ...
     .............
    ..ttttAAAtttt..
  .......ttttt.......
 ..ttttB.......Btttt..
@.....tttt.t.tttt.....@
.tttC....t...t....Cttt.
 ..ttttD.......Dtttt..
   ...tttttEttttt...
      ....ttt....
         .ttt.
         .ttt.
         .ttt.
          .t.
          .t.
           @
ENDMAP

NAME:    hangedman_swamp_pad
TAGS:    transparent extra no_pool_fixup decor
KMONS:   P = plant
KFEAT:   P = shallow_water
SHUFFLE: AB / AB / BA, CD / CD / DC, EF / EF / FE
SUBST:   A = t, B = ., C : Pt~.., D = ., E = t, F = P
KMASK:   ~ = no_monster_gen
SUBST:   ~ = w
MAP
   .www.www.
  .w...w...w.
 .w.B.t.t.B.w.
.w.A.ttttt.A.w.
w.B.t..C..t.B.w
w..t...D...t..w
w.tt..EFE..tt.w
.w.tCDFtFDCt.w.
w.tt..EFE..tt.w
w..t...D.wwt..w
w.B.t..C.wPw..w
.w.A.tttttwPw.w
 .w.B.t.t..wPw.
  .w...w....w.
   .www.wwww.
ENDMAP

#####
# The ruins of a town... all that is left are a few buildings
# and skeletons. These vaults are just to give swamp some variety...
# There are no monsters or loot placed here.
NAME:   evilmike_swamp_ruin_house_1
NSUBST: x = 1:+ / *:x
SUBST:  yx = xxxxx-, - = ----.
: swamp_ruins(_G)
MAP
  ........
 ..........
..yxxyxxxy..
..x--y---x..
..x------x..
..yy-y---x..
..x--yy-yy..
..x--y---x..
..x--y---x..
..yxxyxxxy..
 ..........
  ........
ENDMAP

NAME:   evilmike_swamp_ruin_house_2
SUBST:  x = xxxxx-, - = ----.
: swamp_ruins(_G)
MAP
 ..
 .xxx
 .x----
..x-----
..x---
..x--- ---x
 .x-------x
 .xxxxxxxxx.
 ...........
     ...
ENDMAP

NAME:   evilmike_swamp_ruin_house_3
NSUBST: x = 1:+ / *:x
SUBST:  y = x, x = xxxxx-, - = ----.
: swamp_ruins(_G)
MAP
    .....
   .......
  ..yxxxy..
 ..yy---yy..
..yy-----yy..
..x---y---x..
..x--yyy--x..
..x---y---x..
..yy-----yy..
 ..yy---yy..
  ..yxxxy..
   .......
    .....
ENDMAP

NAME:   evilmike_swamp_ruin_house_4
SUBST:  x = xxxxx-, - = ----.
: swamp_ruins(_G)
MAP
  .......
 ..xxxxx..
..xx---xx..
.xx-----x
.x--   --
.x---
.xx----
..xx--
 ..xx
  ...
ENDMAP

NAME:   evilmike_swamp_ruin_house_5
NSUBST: x = 1:+ / *:x
SUBST:  yx = xxxxx-, - = ----.
: swamp_ruins(_G)
MAP
  ............
 ..............
..yxxxxxyxxxxy..
..x-----y----x..
..x-----y----x..
..x-----y----x..
..yyyy-yy---
..x---y----
..x---yxxxxx
..x---x...
..x---x...
..yxxxy..
 .......
  .....
ENDMAP

NAME:   evilmike_swamp_ruin_house_6
SUBST:  x = xxxxx-, - = ----.
: swamp_ruins(_G)
MAP
.....
.xxxxxxx x
.x-----
.x----   -     x
 x----
 xxxx  x      -x
  ...        --x
          x----x.
         .x----x.
         .x----x.
         .xxxxxx
         ...
ENDMAP

NAME:   evilmike_swamp_ruin_rubble_1
SUBST:  x = xxxx-, - = -----.
: swamp_ruins(_G)
MAP
   .......
  ......x..
 ..xx.......
...xx...xxx..
........x--..
...xx...xxx..
.............
.x-x..xx.....
.x-x..xx...x.
.xxx.........
 .....xxxx..
  ....xxxx.
   .......
ENDMAP

NAME:   evilmike_swamp_ruin_rubble_2
SUBST:  x = xxxx-, - = -----.
: swamp_ruins(_G)
MAP
   .........
  ..xx..xxx..
 ...xx..x--...
..x.....xxx....
.....x......
.........
.xxx...
.--x..
.x-x...
.xxx.....
.....xx.....
..x..xx..xxx...
 ....xx..--x..
  .......xxx.
   .........
ENDMAP

NAME:   evilmike_swamp_ruin_wall
SUBST:  x = xxxx-, - = -----.
: swamp_ruins(_G)
WEIGHT: 4
MAP
        x
       xx
       xx
      .xx.
     .-xx-.
    .--xx--.
   .---xx---.
xxxxxxxxxxxxxxx
 xxxxxxxxxxxxxxx
   .---xx---.
    .--xx--.
     .-xx-.
      .xx.
       xx
       xx
       x
ENDMAP

NAME:   hangedman_swamp_ruin_wall
SUBST:  x = xxxx-, - = -----.
: swamp_ruins(_G)
WEIGHT: 4
MAP
  x
.-xx-....
.-xx-----.
 -xxxxxx-.
.-xxxxxx-.
.-----xx-....
 ....-xx-----.
    .-xxxxxx-.
    .-xxxxxx-
    .-----xx-.
     ....-xx-.
           x
ENDMAP

NAME:    hangedman_swamp_ruin_hall
SHUFFLE: yYzZ / yYzZ / zZyY
NSUBST:  - = 2:d- / *:-, z = 1:+ / *:X, Z = 1:. / *:X
SUBST:   XyY = xxxx-, - = -----.
: swamp_ruins(_G)
WEIGHT:  2
MAP
  ....  ....
 ..XZZZZZZX..
 ..y------Y..
  .y-x--x-Y.
 ..y------Y..
 ..XzzzzzzX..
  ..........
  XXXX--XXXX
.XxxxX--XxxxX.
.XxxxX--XxxxX.
.XxxxX--XxxxX.
  XXXX--XXXX
  ..........
ENDMAP

NAME:   nicolae_swamp_bean_lake
TAGS:   transparent decor
NSUBST: Q = 2=@ / _
SUBST:  D = tt., L : w., R : w., E = w., . = ...W
CLEAR:  _
MAP
Q..  ....Q
..........
.....EwwE...
 ..EwwwwwwE..Q
 ..wwwwwwwwR..
..EwwwwwwwwR..
..wwwwwwwwE..
..wwwwwwE...Dt
..EwwwwE...Dttt
Q..wwww....DDtt
  .EwwE.....Dt
  ..LL..DD...
   ....DtDD.Q
   Q.. tttt
        tt
ENDMAP

NAME:  nicolae_swamp_big_swirl
TAGS:  decor
SUBST: M = ..wt, D = t..
MAP
   tttttt   .@.ttt
 tttDDDDtttD...DDttt
 tDD....DDtD.....DDt
ttD......MwM......Dtt
tD...DD.MwwwM.DD...Dt
tD..DDDDMwwwMDDDD..Dt
tD..DDDDMwwwMDDDD..Dt
tD...DD.MwwwM.DD...Dt
ttD......MwM......Dtt
 tDD.....DtDD....DDt
 tttDD...DtttDDDDttt
   ttt.@.   tttttt
ENDMAP

NAME:   nicolae_swamp_oxbows
TAGS:   decor
NSUBST: D = w / ', E = w / ', F = w / ', H = w / ', J = w / ', K = w / '
NSUBST: L = w / ', M = w / ', N = w / ', O = w / ', P = w / ', Q = w / '
NSUBST: R = w / ', S = w / ', Z = w / ', a = w / ', p = w / ', q = w / '
NSUBST: r = w / ', s = w / ', y = w / ', z = w / ', - = w / ', " = w / '
NSUBST: ` = w / '
SUBST:  ' = W.
MAP
 ''  .@.   '''''
'ww'.....''awwwp''
'www'...'Zwwa'pwwq'
 'wwD'.'SwZ''.''qwr
  'Dw'.'wS'.....'rw
   'w'.'w'.......'w
  'Ew'.'wR'.....'sw
 'FwE'.'RwQ'...'-ws
 HwF'...'QwP'.'"w-'
 wH'.....'Pw'.'w"'
 w'.......'w'.'w'
 wJ'.....'Ow'.'w`'
 JwK''.''NwO'.'`ww'
 'KwwL'MwwN'...'www'
  ''LwwwM''.....'ww'
    '''''   .@.  ''
ENDMAP

NAME:    nicolae_swamp_small_spring
TAGS:    transparent decor
SHUFFLE: DEFHJKLMNOPRS / QQQ___QQ_____/ QQQ___Q___QQQ / __QQQQQ______ \
         / _____QQQ_____ / _____QQ___QQQ / __QQQ_Q_QQQ__ / ______QQQQQ__ \
         / ________QQQQQ / QQQQ___Q_____ / _QQQQQ_______ / _______QQQQQ_ \
         / _____Q___QQQQ / _QQQ_QQQ_QQQ_
SUBST:   DEFHJQ = w, KLMNOPRS = _, a = Ww, ' = .W
CLEAR:   _
MAP
    .'''''......
tttt.     ..wwa..
txxx.DEFHJ.wwwwa.
txwwwwKLMwwwwwwa.
txxx.NOPRS.wwwwa.
tttt.     ..wwa..
    .'''''......
ENDMAP

NAME:    nicolae_swamp_some_circles
TAGS:    transparent decor
# Shuffle guide:
# PQR - sides (Q) guaranteed traversible, center (P)/corners (R) whatever
# DER - sides/center guaranteed blocked, corners whatever
# PFH - corners guaranteed traversible, sides/center whatever
SHUFFLE: PQR/DER/PFH
SUBST:   P : twWpM., Q : WpM., D : tE, E : wt, R : twWM, F : twWpM., H : WM
KMONS:   pM = plant
KFEAT:   M = W
MAP
............
..RR....RR..
.RRRRQQRRRR.
.RRRRQQRRRR.
..RRPPPPRR..
..QQPPPPQQ..
..QQPPPPQQ..
..RRPPPPRR..
.RRRRQQRRRR.
.RRRRQQRRRR.
..RR....RR..
............
ENDMAP

NAME:    nicolae_swamp_tree_designs
TAGS:    transparent decor
SHUFFLE: JKLMNO / ------ / -----q / ----q- / ----qq / ---q-- / ---q-q / \
         ---qqq / --q--- / --q--q / --q-q- / --q-qq / --qq-- / --qq-q / \
         --qqqq / -q---- / -q---q / -q--q- / -q--qq / -q-q-- / -q-q-q / \
         -q-qqq / -qq--- / -qq--q / -qq-q- / -qq-qq / -qqqqq / q----- / \
         q----q / q---qq / q--q-- / q--q-q / q--qqq / q-q--- / q-q--q / \
         q-q-q- / q-q-qq / q-qq-- / q-qq-q / q-qqqq / qq---- / qq---q / \
         qq--q- / qq--qq / qq-q-- / qq-q-q / qq-qqq
SUBST:   JKLMNOq = t, - = ., D = t_, p : t., P : t.
CLEAR:   _
MAP
   DDDDDDDDD
 DDtttttttttDD
Dttt.......tttD
tt...JKLKJ...tt
...p.KMNMK.p...
@..P.LNONL.P..@
...p.KMNMK.p...
tt...JKLKJ...tt
Dttt.......tttD
 DDtttttttttDD
   DDDDDDDDD
ENDMAP

NAME:   nicolae_swamp_tree_isthmus
TAGS:   transparent decor
ORIENT: float
SUBST:  E = .Wtw
MAP
       wwwwwww
     wwwwwwwwwww
   wwwwEEEEEEwwwww
ttwwwEEE....EEwwwwwwwtt
.ttwEE..EEEE.Ewwwwwwtt.
..ttE.EEEwwE.EwwwEEtt..
@....EEwwwE.EwwwEE....@
..ttEEwwwE.EwwEEE.Ett..
.ttwwwwwwE.EEEE..EEwtt.
ttwwwwwwwEE....EEEwwwtt
     wwwwwEEEEEEwwww
       wwwwwwwwwww
         wwwwwww
ENDMAP

NAME:   nicolae_swamp_well_well_well
TAGS:   transparent decor
NSUBST: x = . / xxxx.
SUBST:  p = p..., x : xxxxt, . = ...W
KMONS:  p = plant
KFEAT:  p = . w:30 / W
MAP
 ........
..pppppp..
.ppxxxxpp.
.pxxwwxxp.
.pxwwwwxp.
.pxwwwwxp.
.pxxwwxxp.
.ppxxxxpp.
..pppppp..
 ........
ENDMAP

NAME:   nicolae_swamp_decorative_isthmus
TAGS:   no_pool_fixup transparent decor
ORIENT: float
SUBST:  _ = t_, ' = w:50 ., D = t:50 w, Q = W:50 w
CLEAR:  _
MAP
________________
tttttttttttttttt
tDD''QtDw..'Dttt
t'ww.wtQQWwww'Qt
wQQWwwwW.WwwwwW@
wW.WQQWQQQWQQWQ.
WQQQW.WwwQ...WQQ
.QwQ..QwwQQQQQww
@QwQQWQWwwwwwwDw
QQDt'wWt...'tDtt
tttttttttttttttt
________________
ENDMAP

# Just a simple gag vault: A few people got their boots stuck in the mud here
# and just left them behind. Sometimes generates bardings. I guess those get
# stuck in the mud too.
NAME:    nicolae_swamp_stuck_in_the_mud
TAGS:    transparent
SHUFFLE: Ss, Rr
SUBST:   D = W., E = t..., SR = @, sr = t, M = tttW
NSUBST:  W = 3=p / 3=pWW
KITEM:   p = pair of boots
KFEAT:   p = W
MAP
tttt    tttt
S.EttttttE.R
S..EtMMtE..R
tE.DDWWDD.Et
ttEDDWWDDEtt
tE.DDWWDD.Et
s..EtMMtE..r
s.EttttttE.r
tttt    tttt
ENDMAP

NAME:  nicolae_swamp_little_swirl
TAGS:  decor
SUBST: M = ..wt, D = t..
MAP
  ttttt
 ttDDDttD.@.Dt
ttD...MwM...Dtt
tD...MwwwM...Dt
tD...MwwwM...Dt
tD...MwwwM...Dt
ttD...MwM...Dtt
 tD.@.DttDDDtt
        ttttt
ENDMAP

NAME:    nicolae_swamp_long_stream
TAGS:    decor
ORIENT:  float
SHUFFLE: Pp/Qq/Rr
SUBST:   p = w, P = w_, QqRr = _
CLEAR:   _
MAP
tttt
t...@        RrrrrrR
t.wwww  RrrrrrrRRRrrrrR       ttt
t.wwwwRrrrR qqqqQ   RrrrrrR  ...t
t..wwwwwqqqQq Qqqqq   qqqrrRwww..t
tt... PppPqqq    QqqQQqQqqwwwwww.t
 ttt   PpppP  PppppqqqqppppPwww..t
         PppppppPPppppppP    @..tt
           PPPP    PPPP       ttt
ENDMAP

# http://i.imgur.com/H7nvQFo.jpg
NAME:   nicolae_swamp_little_tower
TAGS:   decor no_pool_fixup
KMONS:  P = plant
NSUBST: X = - / x
SUBST:  T = t-, - = ....P, z = WWw, _ = __w
CLEAR: _
MAP
   ttt___
  ttTwwww___
  tTWwwwwwww___
  tTWwwwwwwwwww___
 tt.Wwwwzzzzzwwwzz
 t.Tzwwzx---xzwwz.
 .tzwwzx-xXx-xzzz.
.Ttwwwz-xx-xx-zz-.
@Ttwwwz-X---X-WW-@
.Ttwwwz-xx-xx-zz-.
 .tzwwzx-xXx-xzzz.
 t.Tzwwzx---xzwwz.
 tt.Wwwwzzzzzwwwzz
  tTWwwwwwwwwww___
  tTWwwwwwww___
  ttTwwww___
   ttt___
ENDMAP

NAME:  nicolae_swamp_dense_foliage
TAGS:  decor transparent
SUBST: _ = ._, - = t_, t = tttttt., . = ......W
CLEAR: _
MAP
         -_-
      -_-.t.---
   -_-.t.ttt.t.-
  -.t.ttt.t.t.t.-
 -.ttt.t.t.t.ttt_
 -t.t.t.t.ttt.t.-
 -.t.t.ttt.t.t.t.-
-.t.ttt.t.t.t.ttt_
_ttt.t.t.t.ttt.t.-
-.t.t.t.ttt.t.t.t.-
 -.t.ttt.t.t.t.ttt_
 _ttt.t.t.t.ttt.t.-
 -.t.t.t.ttt.t.t.-
  -.t.ttt.t.t.t.t-
  _ttt.t.t.t.ttt.-
  -.t.t.t.ttt.t.-
   -.t.ttt.t.-_-
    ---.t.-_-
       -_-
ENDMAP

NAME:  nicolae_swamp_very_dense_foliage
TAGS:  decor transparent
SUBST: _ = ._, - = t_, t = tttttt., . = ......W
CLEAR: _
MAP
       -_-
      tt.----_
   --tttt.--.-_-
   -.ttttt..tt.-----
   --.tt..ttttt.--.-
   --.t.tt.ttttt..tt
  --.t.tttt.tt..ttttt
  _.tt.tttt.t.tt.tttt-
 _-tttt.tt.t.tttt.tt._
 -.ttttt..tt.tttt.t.--
 --.tt..ttttt.tt.t.--
 --.t.tt.ttttt..tt.--
--.t.tttt.tt..ttttt.-
_.tt.tttt.t.tt.ttttt_
-tttt.tt.t.tttt.tt._
 ttttt..tt.tttt.t.--
  tt..ttttt.tt.t.--
  -.--.ttttt..tt.--
  -----.tt..ttttt.-
      -_-.--.ttttt-
        _----.tt
            -_-
ENDMAP

###############################################################################
#
# <<4>> Storage ending vaults
#
# They come in two flavours: normal and themed. The first three are normal and
# use regular swamp monsters. The other five have special themes, and are less
# common.
#
###############################################################################

default-depth:

NAME:    swamp
TAGS:    transparent
PLACE:   Storage:$
WEIGHT:  20
ORIENT:  float
MAP
@..@
....
....
@..@
ENDMAP
