################################################################################
# vaults_rooms_hard.des: Subvaults for the Fortress.
#
# Content: These are the subvaults that place a large number of monsters and
#          out of depth monsters.
################################################################################
#
# All of the subvaults in here should use the tag vaults_hard
#
# You can additionally use the following tags:
#
# vaults_orient_n vaults_orient_s vaults_orient_e vaults_orient_w
# no_windows preserve_wall
#
# vaults_orient_x: controls the entry points to the subvault.
# A subvault using vaults_orient_n will always be entered from the north side,
# as it appears in the .des. Multiple orient tags may be used.
#
# no_windows: prevents the layout from creating windows into the subvault.
#
# preserve_wall: prevents the layout from changing rock into the same wall type
# as the rest of the floor.
#
################################################################################

: crawl_require('dlua/vault.lua')

####

NAME:    st_diamondy
TAGS:    vaults_hard
MAP
xxxxx..x..xxxxx
xxxx...x...xxxx
xxx...xxx...xxx
xx...xx.xx...xx
x.............x
...x.......x...
..xx.......xx..
xxx.........xxx
..xx.......xx..
...x.......x...
x.............x
xx...xx.xx...xx
xxx...xxx...xxx
xxxx...x...xxxx
xxxxx..x..xxxxx
ENDMAP

NAME:    st_cross
TAGS:    vaults_hard
MAP
xxxxx.xxxxx
xxxx...xxxx
xxxxx.xxxxx
xxx.....xxx
x.x.x+x.x.x
....+.+....
x.x.x+x.x.x
xxx.....xxx
xxxxx.xxxxx
xxxx...xxxx
xxxxx.xxxxx
ENDMAP

NAME:    st_octagons_1
TAGS:    vaults_hard
MAP
.......x.....x....x..
.......x.....x....x..
......xx.....xx..xx..
.....xx.......x++x...
....+x..xx+xx........
...xx..xx...xx.....xx
..xx...x.....x....xx.
xxx....xx...xx...xx..
........xx+xx....+...
.................+...
x+xx......xx+xx..xx..
...xx....xx...xx..xx.
....xx..xx.....xx..xx
.....x..x.......x....
.....x..x.......x....
ENDMAP

NAME:    st_octagons_2
TAGS:    vaults_hard
MAP
.....x..x........x...
.....x..x........x...
....xx..xx......xx...
...xx....xxx..xxxx...
x++x.....x.x++x..xx..
x........x........x++
xx......xx...........
.xx....xx............
..x+xx+x.............
.................xx+x
......xx+xx.....xx...
x++x.xx...xx...xx....
x..xxx.....xx+xx.....
....xx.....x...x.....
....xx.....x...x.....
ENDMAP

NAME:    st_hourglassy
TAGS:    vaults_hard
TAGS:    vaults_orient_n vaults_orient_s
MAP
xxxxxxx...xxxxxxx
xxxxxx.....xxxxxx
xxxx.........xxxx
xx.............xx
x...............x
xx.............xx
xxxx.........xxxx
xxxxxx.....xxxxxx
xxxxxxx...xxxxxxx
ENDMAP

NAME:    st_eye
TAGS:    vaults_hard
TAGS:    vaults_orient_n vaults_orient_s
MAP
xxxxxxxxx..xxxxxxxxx
xx...xxxx..xxxx...xx
x.....xx....xx.....x
x.....xx....xx.....x
x....xx......xx....x
x...xx..x..x..xx...x
x..................x
x..................x
x...xx..x..x..xx...x
x....xx......xx....x
x.....xx....xx.....x
x.....xx....xx.....x
xx...xxxx..xxxx...xx
xxxxxxxxx..xxxxxxxxx
ENDMAP

NAME:    st_star
TAGS:    vaults_hard
TAGS:    vaults_orient_n vaults_orient_s
MAP
xxxxxxxxxxxx..xxxxxxxxxxxx
x..xxxxxxx......xxxxxxx..x
x....xxx..........xxx....x
xx..........xx..........xx
xxxx.......xxxx.......xxxx
xxxx.......xxxx.......xxxx
xx..........xx..........xx
x....xxx..........xxx....x
x..xxxxxxx......xxxxxxx..x
xxxxxxxxxxxx..xxxxxxxxxxxx
ENDMAP

NAME:    st_quartered_hall
TAGS:    vaults_hard
MAP
xxxxxxx..xxxxxxx
x....x....x....x
xx..xx....xx..xx
xxx+x......x+xxx
xxx...x..x...xxx
x...x......x...x
................
................
x...x......x...x
xxx...x..x...xxx
xxx+x......x+xxx
xx..xx....xx..xx
x....x....x....x
xxxxxxx..xxxxxxx
ENDMAP

NAME: grunt_vaults_funneled_arena
TAGS: vaults_hard
NSUBST: 9 = 1:8 / *:9
SUBST: 0 = 90000000
KMONS: 0 = 0 band
SUBST: $ = |***$$$$
MAP
  x.....xxxxx...xxxxx.....x
 xx......xxxxx.xxxxx......xx
xx.......+...x.x...+.......xx
.........xx..x.x..xx.........
........xxx.......xxx........
.......xxxxx.....xxxxx.......
......xxxxxx.....xxxxxx......
.....xxxxxxxx...xxxxxxxx.....
x...xxxxxxxxx...xxxxxxxxx...x
xx+xxxxxxxxxxx.xxxxxxxxxxx+xx
xx.xxxxxxxxxxx.xxxxxxxxxxx.xx
xx...xxxxxxxxx+xxxxxxxxx...xx
xx.....xxxxxx...xxxxxx.....xx
.xxx.....xxx.....xxx.....xxx.
...........+..G..+...........
.xxx.....xxx.....xxx.....xxx.
xx.....xxxxxx...xxxxxx.....xx
xx...xxxxxxxxx+xxxxxxxxx...xx
xx.xxxxxxxxxxx.xxxxxxxxxxx.xx
xx+xxxxxxxxxxx.xxxxxxxxxxx+xx
x...xxxxxxxxx...xxxxxxxxx...x
.....xxxxxxxx...xxxxxxxx.....
......xxxxxx.....xxxxxx......
.......xxxxx.....xxxxx.......
........xxx.......xxx........
.........xx..x.x..xx.........
xx.......+...x.x...+.......xx
 xx......xxxxx.xxxxx......xx
  x.....xxxxx...xxxxx.....x
ENDMAP

NAME: nicolae_vaults_quadrants
TAGS: vaults_hard
SUBST: m : +++xxm, n : +x
MAP
     .......
   ...xm+mx...
  ..xxx...xxx..
 ..xx.......xx..
 .xxxx.....xxxx.
..x.xxx...xxx.x..
.xx..xxn+nxx..xx.
.m....x...x....m.
.+....x.G.x....+.
.m....x...x....m.
.xx..xxxxxxx..xx.
..x.xxx...xxx.x..
 .xxxx.....xxxx.
 ..xx.......xx..
  ..xxx...xxx..
   ...xm+mx...
     .......
ENDMAP

NAME: nicolae_vaults_halls_meeting
TAGS: vaults_hard
MAP
xxxx..xxxx..xxxx
x..xx......xx..x
x...xx....xx...x
xx...xx++xx...xx
.xx...x..x...xx.
..xx..+..+..xx..
x..xx+x..x+xx..x
x..+...xx...+..x
x..+...xx...+..x
x..xx+x..x+xx..x
..xx..+..+..xx..
.xx...x..x...xx.
xx...xx++xx...xx
x...xx....xx...x
x..xx......xx..x
xxxx..xxxx..xxxx
ENDMAP

NAME: nicolae_vaults_octagons
TAGS: vaults_hard
SHUFFLE: abcdefgh, ijklmnop
SUBST: abcdefgijklmno = x, hp = .
MAP
      .....
     .......
    ..iiiii..
   ..pp...jj..
  ..pp.....jj..
 ..pp..aaa..jj..
..op..hh.bb..jk..
..o..gh...bc..k..
..o..g.....c..k..
..o..gf...dc..k..
..on..ff.dd..lk..
 ..nn..eee..ll..
  ..nn.....ll..
   ..nn...ll..
    ..mmmmm..
     .......
      .....
ENDMAP

NAME:    nicolae_vaults_disappearing_quadrants
TAGS:    vaults_hard
SHUFFLE: FMNS, DEH, JKL, OPQ, RZ-
SUBST:   FJORD = ., MEKPZ = x, N : xx., S : xx., H : xx., L : xx., Q : xx., \
         - : xx.
MAP
......................
....DDEE......JJKK....
..DDD..EEE..JJJ..KKK..
..D......E..J......K..
.DD......EEJJ......KK.
.D...xx...EJ...xx...K.
.H...xx...FM...xx...L.
.HH......FFMM......LL.
..H......F..M......L..
..HHH..FFF..MMM..LLL..
....HHFF......MMLL....
....RRSS......NNOO....
..RRR..SSS..NNN..OOO..
..R......S..N......O..
.RR......SSNN......OO.
.R...xx...SN...xx...O.
.-...xx...ZQ...xx...P.
.--......ZZQQ......PP.
..-......Z..Q......P..
..---..ZZZ..QQQ..PPP..
....--ZZ......QQPP....
......................
ENDMAP

NAME:    nicolae_vaults_shipping_containers_1
TAGS:    vaults_hard
SHUFFLE: DE, FH, JK, LM, NO
SUBST:   DFJLN = +, E : xxxx+, H : xxxx+, K : xxxx+, M : xxxx+, O : xxxx+
MAP
........................
......xFFx..............
..xDDxx--xxJJxxLLx.xNNx.
..x--xx--xx--xx--x.x--x.
..x--xx--xx--xx--x.x--x.
..x--xx--xx--xx--x.x--x.
..x--xxHHxx--xx--x.x--x.
..xEEx....xKKxxMMx.xOOx.
........................
........................
ENDMAP

NAME:    nicolae_vaults_shipping_containers_2
TAGS:    vaults_hard
SHUFFLE: DE, FH, JK, LM
SUBST:   DFJL = +, E : xxxx+, H : xxxx+, K : xxxx+, M : xxxx+
MAP
.......xxxxxx.
.xDDx..J----K.
.x--x..J----K.
.x--x..xxxxxx.
.x--x.........
.x--xxxxxxx...
.xEExF----H...
.....F----H...
.....xxxxxx...
.......xxxxxx.
xxxxxx.L----M.
x----+.L----M.
x----+.xxxxxx.
xxxxxx........
ENDMAP

NAME:    nicolae_vaults_shipping_containers_3
TAGS:    vaults_hard
SHUFFLE: DE, FH, JK
SUBST:   DFJ = +, E : xxxx+, H : xxxx+, K : xxxx+
MAP
..............
......xxxxxx..
xDDx..F----H..
x--x..F----H..
x--x..xxxxxx..
x--x..........
x--x..........
xEEx.xxxxxx...
.....J----K...
.....J----K...
.....xxxxxx...
ENDMAP

NAME:    nicolae_vaults_shipping_containers_4
TAGS:    vaults_hard
SHUFFLE: DE, FH
SUBST:   DF = +, E : xxxx+, H : xxxx+
MAP
.xxxxxx..
.D----E..
.D----E..
.xxxxxx..
..xxxxxx.
..F----H.
..F----H.
..xxxxxx.
.........
ENDMAP

NAME:    nicolae_vaults_shipping_containers_5
TAGS:    vaults_hard
SHUFFLE: DEFH
SUBST:   DEF = +, H : xxxx+
MAP
xxxxxx.......
x----+.......
x----+.......
xxxxxx.......
.........xFFx
...xxxxxxx--x
...+----xx--x
...+----xx--x
...xxxxxxx--x
...xxxxxxxHHx
...D----E....
...D----E....
...xxxxxx....
ENDMAP

NAME:    nicolae_vaults_shipping_containers_6
TAGS:    vaults_hard
SHUFFLE: DE, FH, JK/ML, LM
SUBST:   DFJL = +, E : xxxx+, H : xxxx+, K = x, M : ++++x
MAP
................
................
.xxxxxx.xxxxxx..
.D----E.F----H..
.D----E.F----H..
.xxxxxx.xxxxxx..
..xxxxxxxxxxxx..
..+----xx----+..
..+----xx----+..
..xxxxxxxxxxxx..
..xxxxxx........
..J----Kxxxxxx..
..J----KL----M..
..xxxxxxL----M..
........xxxxxx..
................
ENDMAP

NAME:    nicolae_vaults_shipping_containers_7
TAGS:    vaults_hard
SHUFFLE: DE/FH/JK, FH, JK
SUBST:   DEFJ = +, H : xxxx+, K : xxxx+
MAP
.....xxxxxx.
.....D----E.
.....D----E.
.....xxxxxx.
...xxxxxx...
...F----H...
...F----H...
...xxxxxx...
..xxxxxx....
..J----K....
..J----K....
..xxxxxx....
ENDMAP

NAME:  nicolae_vaults_tangent_ellipses
TAGS:  vaults_hard
MAP
.....xxxxxxxxxxxxxxx.....
.....xx...........xx.....
......+...........+......
......xx.........xx......
.......xxx.....xxx.......
xx.......xxx+xxx.......xx
xx+x....xx.....xx....x+xx
x..xx..xx.......xx..xx..x
x...x.xx.........xx.x...x
x...xxx....xxx....xxx...x
x....x....xx.xx....x....x
x....x...xx...xx...x....x
x....+...x.....x...+....x
x....x...xx...xx...x....x
x....x....xx.xx....x....x
x...xxx....x+x....xxx...x
x...x.xx.........xx.x...x
x..xx..xx.......xx..xx..x
xx+x....xx.....xx....x+xx
xx.......xxx+xxx.......xx
.......xxx.....xxx.......
......xx.........xx......
......+...........+......
.....xx...........xx.....
.....xxxxxxxxxxxxxxx.....
ENDMAP
